twothousandeighthundredninetyfive -- links -> onethousandonehundredfiftyeight;
onethousandfourhundredthirtyfive -- links -> onethousandsevenhundredsixtyone;
onethousandonehundredninetyfive -- links -> fourthousandsevenhundredten;
threehundredseventynine -- links -> onethousandsevenhundredfifteen;
twothousandeighthundredthree -- links -> threethousandfivehundredninetysix;
threethousandfivehundredthirtynine -- links -> twothousandsixhundred;
fourthousandthreehundredeightyfour -- links -> fourthousandsevenhundredfour;
eighthundredseventyeight -- links -> onehundredfifty;
sixhundredsixtytwo -- links -> twothousandonehundrednineteen;
fiftytwo -- links -> fourthousandsixhundrednine;
fourthousandsevenhundredninetyfour -- links -> eighthundredtwentyone;
threethousandtwohundredseventyfour -- links -> fourthousandfivehundredfiftyseven;
onethousandninehundredseventyeight -- links -> twohundredthirteen;
sevenhundredsixtyone -- links -> onethousandeighthundredeightyone;
fourthousandninehundredfiftynine -- links -> onethousandninehundredsixtythree;
onethousandsixhundredfiftyfour -- links -> threethousandsevenhundredseventyfour;
onehundredtwentyone -- links -> onethousandsixhundredtwentyfour;
threethousandninehundredtwo -- links -> fourthousandninehundredtwo;
threethousandonehundredtwentyeight -- links -> onethousandthreehundredeightynine;
onethousandtwohundredthree -- links -> threethousandfivehundredthirty;
twothousandfivehundredfortysix -- links -> threethousandeighthundredthree;
fourthousandtwohundredfiftyfive -- links -> fourthousandsixhundredsixty;
onethousandsixhundredseventyeight -- links -> fourthousandonehundredfortythree;
fourthousandsevenhundredthirtynine -- links -> fourthousandthreehundredeightyseven;
onethousandfivehundredsixtythree -- links -> threethousandthreehundredfifteen;
sixhundredfive -- links -> twothousandthirtyseven;
twothousandonehundredeightynine -- links -> fourthousandninehundredninetynine;
twothousandeighthundredeightyfive -- links -> onehundredeleven;
onethousandninehundredfifty -- links -> sixhundredthirtyone;
threethousandonehundredfortysix -- links -> threethousandfourhundredseventynine;
twothousandfourhundredthirtyseven -- links -> fourthousandfivehundredseventyfour;
threethousandeightyfive -- links -> twothousandninehundredfiftyfive;
fourthousandeighthundredthirtyeight -- links -> fivehundredtwenty;
twothousandfourhundredfortynine -- links -> threethousandsevenhundredfourteen;
twohundredeightysix -- links -> twothousandeighthundredtwentynine;
twothousandtwohundredfortysix -- links -> onethousand;
fourthousandtwentyfour -- links -> twothousandeighthundredfiftyseven;
twothousandsixhundredseventeen -- links -> fourthousandtwohundredeightyseven;
fourthousandtwohundredsixtyfive -- links -> fortyeight;
fivehundredseventyseven -- links -> threethousandfortyeight;
fourthousandninehundredthirtythree -- links -> threethousandonehundredfortythree;
sevenhundredfive -- links -> threethousandonehundredninetythree;
onethousandtwohundredsixty -- links -> fourhundredseventyeight;
fourthousandtwohundredthirtyseven -- links -> threethousandsixhundredeightyone;
fourthousandonehundredfiftysix -- links -> twothousandsixhundredseventythree;
twothousandonehundredeightyseven -- links -> fourthousandninetyfive;
twothousandfivehundredninetyfive -- links -> sevenhundredseventyfour;
twothousandfivehundredtwentyseven -- links -> threethousandfourhundredfiftyseven;
ninehundredseventyeight -- links -> onethousandsevenhundredfortyfour;
onethousandsevenhundredseventy -- links -> onethousandeighthundredfortyeight;
threethousandfortyone -- links -> threethousandthreehundredninetyfour;
twothousandthreehundredsixty -- links -> onethousandfivehundredsixtyseven;
onethousandfourhundrednineteen -- links -> fourthousandonehundredtwenty;
twothousandfourhundredfive -- links -> fourthousandfourhundredninetythree;
threethousandsixhundredfifteen -- links -> fourthousandeighthundredseventynine;
fourthousandsixhundredninetytwo -- links -> fourthousandfourhundredeightyeight;
onethousandsevenhundredseventyfive -- links -> twothousandsevenhundrednine;
fourthousandonehundredthirtytwo -- links -> twothousandthreehundredsixtytwo;
twothousandsevenhundredtwentyone -- links -> threethousandninehundredninetyfive;
onehundredninetynine -- links -> onethousandthreehundredthirtysix;
onethousandonehundredsixtyeight -- links -> onethousandthreehundredninetynine;
twothousandfivehundredninetyone -- links -> ninehundred;
fourthousandsevenhundredfifty -- links -> threethousandtwohundredtwentyone;
onethousandthreehundredfiftyone -- links -> fourthousandfortyfour;
fourhundredninetysix -- links -> sixhundredeightysix;
fourthousandninehundredfortyeight -- links -> onethousandtwohundredninetyone;
onethousandonehundredninety -- links -> fourthousandsixhundredseventythree;
onethousandtwohundredfifteen -- links -> fourthousandninehundredtwo;
threethousandonehundredfortyone -- links -> threethousandfivehundredfiftyseven;
onethousandsevenhundredsixtyeight -- links -> twothousandonehundredtwentyone;
fourthousandthreehundredfifteen -- links -> threethousandfivehundredeightyfive;
threethousandfivehundredsixtyseven -- links -> onethousandsevenhundredfortyfour;
twothousandtwohundredfiftyfive -- links -> onethousandfivehundredninetyfour;
fourthousandsixhundredtwentysix -- links -> fourthousandninehundredtwentytwo;
threethousandsixtysix -- links -> twelve;
ninehundredthirtyfive -- links -> sevenhundredfiftyone;
onethousandseventy -- links -> onethousandsixtyeight;
twothousandtwohundredfortyfour -- links -> twohundredseventyfour;
threehundredthirtyseven -- links -> twohundredseventeen;
twothousandfourhundredtwentyseven -- links -> sixhundredseventeen;
fourthousandsevenhundredtwo -- links -> twothousandthreehundredtwentythree;
onethousandninehundredthirtyone -- links -> threehundredfive;
twentyfour -- links -> fourthousandfourhundredeightyfour;
twothousandseventyseven -- links -> threethousandseventyone;
fivehundredforty -- links -> onethousandeighthundredtwelve;
fivehundredtwentyfour -- links -> threehundredtwentyone;
onethousandonehundredfourteen -- links -> fourhundredthirtytwo;
fourhundredseventynine -- links -> threethousandninetyone;
fourhundredseven -- links -> onethousandfourhundredeighteen;
fourhundredninetyfive -- links -> onethousandfourhundredthirty;
fourthousandsixhundredfiftynine -- links -> twohundredthirtysix;
threethousandfivehundredsixty -- links -> twothousandfourhundredthree;
fourthousandsixhundredsixtysix -- links -> onethousandtwohundredtwentynine;
twothousandfourhundredsixtytwo -- links -> ninehundredseventythree;
fourhundredfortynine -- links -> fourthousandfivehundredfiftyeight;
threethousandeighthundredfour -- links -> fourthousandfivehundredseven;
onethousandthreehundredninety -- links -> threethousandsevenhundredtwo;
fourthousandsevenhundredtwentyfour -- links -> onethousandeighthundredfive;
twothousandeighthundredfour -- links -> fourthousandtwohundredseventythree;
fourthousandfivehundredfifty -- links -> fourthousandtwentytwo;