sixhundredninetytwo -- links -> onethousandeighthundredseventy;
threethousandsevenhundredsixtyfour -- links -> onehundredtwelve;
threethousandfivehundredsixtyeight -- links -> twothousandeighthundredseventyfive;
threethousandfourhundredninety -- links -> onehundredthree;
twothousandfourhundredeightynine -- links -> threehundredeightyone;
fourthousandsixhundredten -- links -> onethousandsevenhundredtwelve;
ninehundredninetytwo -- links -> onethousandtwohundrednineteen;
threethousandsevenhundredthirtythree -- links -> fourthousandonehundred;
twothousandninehundredninetyfour -- links -> twothousandthreehundredforty;
onethousandninehundredninetyone -- links -> twothousandthreehundredsixtyfour;
eighthundredfortyseven -- links -> onethousandtwenty;
threethousandthirtythree -- links -> twothousandthreehundredfifteen;
fivehundredseventyfive -- links -> threethousandfivehundredfortyseven;
eighthundredtwentyseven -- links -> threethousandtwohundredeightyfive;
twothousandonehundredsix -- links -> twothousandfourhundredfortythree;
onehundredeightyfour -- links -> twothousandfourhundredtwentyone;
fourthousandfivehundredninetysix -- links -> twothousandthirtytwo;
fourthousandtwohundredninetythree -- links -> ninehundredfiftyfive;
onethousandonehundredseventytwo -- links -> twothousandninehundredeightysix;
twothousandninehundredfiftyone -- links -> twothousandonehundredthirtythree;
fourthousandfourhundredeighty -- links -> twothousandeightyfive;
threethousandninehundredthirtysix -- links -> onethousandfourhundredtwelve;
eighthundredeightyseven -- links -> onethousandtwohundredninetyeight;
fourthousandsixhundredfiftyfour -- links -> threethousandsixhundredfiftysix;
fourthousandonehundredthirty -- links -> fourthousandninehundredfortytwo;
threethousandfivehundredsixty -- links -> twothousandfivehundredthirtyfour;
onethousandtwentyfour -- links -> onethousandeighty;
twothousandsixhundredfourteen -- links -> threethousandonehundredeightynine;
fourthousandninehundred -- links -> onethousandeighthundredsixtyfour;
threethousandninehundred -- links -> twothousandfourhundredforty;
fourthousandthreehundredfortyone -- links -> fourthousandsixhundredfiftynine;
twohundredthirtyfour -- links -> threethousandthreehundredfiftyseven;
threehundredseventy -- links -> onethousandfourhundredthirtyfive;
onethousandfourhundredsixtyseven -- links -> onethousandthreehundredeightyeight;
threethousandsixhundred -- links -> threethousandsixhundredninetyone;
twothousandfourhundredeightyeight -- links -> threethousandninehundredsixteen;
twothousandtwohundredninetyseven -- links -> fourthousandeighthundredseventeen;
onethousandfivehundredeightyfive -- links -> fourthousandfivehundredfiftynine;
onethousandsevenhundredseventyeight -- links -> fourthousandthreehundredsixtyfour;
twothousandeighthundredthirtynine -- links -> onethousandtwohundredthirtyeight;
fivehundredfourteen -- links -> fourthousandninehundredeightyeight;
fourthousandninehundredtwentyone -- links -> threethousandfivehundredeleven;
twentysix -- links -> onethousandsevenhundredtwenty;
onethousandninehundredfiftythree -- links -> threethousandfourhundredninetyeight;
onethousandthreehundredfiftyeight -- links -> twothousandfivehundredninetyfive;
onethousandtwohundrednine -- links -> threethousandninehundredseventyone;
twothousandtwohundredthirtyeight -- links -> onethousandfourhundredeight;
threethousandninehundredfortyfour -- links -> twothousandthreehundredfiftyfour;
onethousandthreehundredthirtyseven -- links -> threethousandthreehundredninetyseven;
twothousandfivehundredfiftyfive -- links -> fourthousandfifteen;
twothousandninehundredthree -- links -> threethousandfourhundredfour;
threethousandthreehundredeightysix -- links -> onethousandninehundredfortyfour;
threethousandeighthundredeight -- links -> onethousandsevenhundredtwentythree;
fourthousandfourhundredfortyeight -- links -> sixtynine;
twothousandsixhundredfortyseven -- links -> threethousandfourhundredsixtyone;
onethousandeighthundredsix -- links -> sixhundredfiftyeight;
onethousandeighthundredsixtyone -- links -> fourthousandseventyfour;
onethousandninehundredninetyseven -- links -> onethousandsevenhundredseventynine;
onethousandsixhundredninetynine -- links -> onethousandfivehundredseventyseven;
twothousandeighthundredtwentynine -- links -> twothousandthreehundredsixtyseven;
onethousandeighthundredfortyseven -- links -> fourthousandonehundredtwo;
fourhundredfifteen -- links -> threethousandninehundredseventynine;
threethousandsixhundredsixtysix -- links -> fourthousandtwohundredtwentythree;
twothousandeighthundredtwenty -- links -> onethousandfivehundredseventysix;
threehundredfortynine -- links -> onethousandninehundredtwentyeight;
fourthousandonehundredtwenty -- links -> fourthousandsevenhundredfifty;
twohundredninetythree -- links -> onethousandninehundredsixtysix;
twothousandsixhundredthirtyone -- links -> onethousandseventynine;
twothousandeighthundredthirtyfour -- links -> eighthundredseventythree;
threethousandsixhundredeightytwo -- links -> fourthousandsevenhundredfiftytwo;
onethousandeighthundredsixtythree -- links -> onethousandfourhundredtwo;
twothousandtwentynine -- links -> seventyfour;
sixhundredseventynine -- links -> onethousandtwohundredseventysix;
onethousandtwentyfour -- links -> onethousandfourhundredfiftyfive;
threethousandeighthundredfive -- links -> twothousandfivehundredfiftyone;
threehundredfiftytwo -- links -> onethousandsixhundredforty;
fourthousandsevenhundredseventeen -- links -> threethousandtwentythree;
fourthousandeighthundredsixtyfive -- links -> twothousandninehundredeightyseven;
onethousandsixhundredninetythree -- links -> threethousandsevenhundredninetyfive;
threethousandninehundredsixtythree -- links -> twothousandsevenhundredfourteen;
threethousandeighthundredtwo -- links -> threethousandfortynine;
fourthousandtwohundredninetyfive -- links -> twothousandtwohundredthirtyone;
threethousandfivehundredeightyfour -- links -> twothousand;
fourthousandtwohundredninetytwo -- links -> twothousandfiftyone;
twohundredseventeen -- links -> fourthousandsixhundredsixtynine;
fourthousandeighthundredseventeen -- links -> onethousandninehundredfifty;
fourthousandtwohundredfiftyseven -- links -> onethousandsixtythree;
threethousandonehundredeightyfive -- links -> twothousandsevenhundredeightyfour;
threethousandtwohundredfour -- links -> twothousandthreehundredthirtyfour;
twothousandsixhundredfortyseven -- links -> fourthousandthreehundredten;
fourthousandfourhundredseventyseven -- links -> threethousandthreehundredfiftyseven;
onehundred -- links -> fourthousandonehundredtwentyone;
onethousandeighthundredsixtyseven -- links -> onethousandsevenhundredsixtyeight;
twothousandfourhundredtwelve -- links -> twohundredsixteen;
sevenhundredfourteen -- links -> twothousandthirtythree;
twothousandsixhundredfiftyseven -- links -> threethousandfivehundredfortynine;
onethousandfourhundredninetytwo -- links -> threethousandthreehundredseventythree;
twothousandthreehundredthirty -- links -> threethousandthreehundredseventythree;
twothousandtwohundredeighteen -- links -> onethousandfivehundredninetyfive;
twothousandtwohundredeightyfive -- links -> eighthundredninetyseven;
fourthousandtwohundredfortythree -- links -> fourthousandeighthundredtwentynine;
twohundredsixtyeight -- links -> fourhundredeighteen;
fourthousandthreehundredninetynine -- links -> fourthousandsevenhundredeightythree;
twothousandeighthundredninetyfour -- links -> threethousandonehundredtwentyone;
threethousandninehundredseventysix -- links -> threethousandfivehundred;
onethousandninetythree -- links -> onethousandsevenhundredthirtytwo;
twothousandsevenhundredtwo -- links -> fourthousandonehundrednineteen;
threethousandthreehundredninetyone -- links -> fourthousandsevenhundredeightyone;
twothousandninehundredninetyeight -- links -> fourthousandonehundredthirtyfive;
onethousandfiftyone -- links -> onethousandonehundredeightynine;
onethousandeighthundredeightysix -- links -> threethousandthreehundredsixteen;
threethousandsixhundredtwo -- links -> onethousandfourhundredfiftythree;
twothousandonehundrednineteen -- links -> fourthousandfivehundredfortytwo;
threethousandthreehundredtwentyeight -- links -> onethousandthreehundredseventythree;
onethousandsevenhundrednineteen -- links -> twothousandeighthundredninetyfour;
ninehundredfortynine -- links -> onethousandfourhundredfiftythree;
onethousandfourhundredthree -- links -> onethousandthreehundredseventytwo;
threethousandtwohundredthirteen -- links -> twothousandfiftysix;
fourthousandtwohundredninetyfour -- links -> onehundredtwo;
onethousandthreehundredsixtyeight -- links -> threethousandtwentyfive;
onethousandthirtytwo -- links -> threethousandninehundredfourteen;
fourthousandeighthundredfortysix -- links -> onethousandninehundredtwentysix;
sevenhundredseventythree -- links -> sevenhundredthirtyeight;
threethousandonehundredfortyseven -- links -> onethousandtwohundredtwentyfive;
fourthousandtwohundredthirtytwo -- links -> eighthundredthirtynine;
onethousandfivehundredseventynine -- links -> twothousandsevenhundredninetyeight;
threethousandninehundredninetysix -- links -> onethousandfivehundredtwentyone;
eighthundredfifty -- links -> onethousandsixhundredsix;
threethousandtwohundredeighty -- links -> threethousandfivehundredninetyfour;
twothousandonehundredthirty -- links -> sixhundredseventythree;
threethousandfourhundredthirtyseven -- links -> onethousandsixtysix;
twohundredfiftyeight -- links -> onethousandonehundredthirtyone;
threethousandthreehundredninetyseven -- links -> twothousandfortyfive;
threethousandfourhundredseventytwo -- links -> threethousandfourhundredthirteen;
onethousandeighthundredeightyone -- links -> twothousandsevenhundredthirteen;
eighthundredthree -- links -> fourthousandtwohundredfortyfour;
twothousandfourhundredthirtyeight -- links -> threethousandeighthundredsixtyeight;
onehundredthree -- links -> onethousandeighthundredseventynine;
onethousandthreehundredten -- links -> twothousandfivehundredninetyfour;
threethousandtwentyone -- links -> threethousandfourhundredseventythree;
twothousandfivehundredthirtyfive -- links -> ninehundredeightyseven;
sevenhundredeighteen -- links -> fourthousandninehundredfortythree;
ninehundredthirtyeight -- links -> twohundredninetynine;
twothousandfourhundredfiftythree -- links -> fourthousandfivehundredeighty;
fourthousandninehundredthirtyseven -- links -> onethousandfourhundredsixtyeight;
fourthousandninehundredseventyfour -- links -> fourhundredfortyseven;
twothousandthreehundredfifty -- links -> twothousandfourhundredtwentytwo;
threethousandfourhundredtwentythree -- links -> onethousandninehundredtwentysix;
threethousandfive -- links -> threehundredfiftyeight;
threethousandeighthundredseventeen -- links -> twohundredtwelve;
twothousandfiftythree -- links -> threehundredforty;
fourthousandsevenhundredthirty -- links -> threethousandfivehundredeighteen;
fourthousandninehundredtwentyeight -- links -> threehundredseventyfour;
threethousandfourhundredtwentyseven -- links -> sevenhundredninetyfive;
fourhundredtwentyeight -- links -> fourthousandsixhundredeighteen;
onethousandonehundredseventyseven -- links -> threethousandninehundredfortyfive;
fourthousandfivehundredone -- links -> sevenhundredseventyseven;
onethousandonehundredthirtynine -- links -> fivehundredseventytwo;
twothousandonehundredninetythree -- links -> twothousandsevenhundredseventyfive;
fivehundredseventyfour -- links -> twothousandtwohundredeightytwo;
fourthousandfivehundredfiftytwo -- links -> fourthousandsixhundredseven;
fourthousandeighthundredninetysix -- links -> threethousandfivehundredsixtytwo;
twothousandeighthundredseventyeight -- links -> fourthousandsixhundredseventysix;
threethousandonehundredninetyone -- links -> fourthousandeighthundredthirtyfive;
fourthousandtwentythree -- links -> onethousandsevenhundredfortysix;
threethousandtwohundredsixtynine -- links -> threethousandsevenhundredsixtynine;
sevenhundredeightytwo -- links -> fourthousandtwohundredfortytwo;
twothousandonehundredfifteen -- links -> twothousandfourhundredfortytwo;
fivehundredfive -- links -> fourthousandfourhundredthirtysix;
twothousandfivehundredninetynine -- links -> twothousandfourhundredseventyeight;
twothousandonehundredsixteen -- links -> onethousandsevenhundredfiftynine;
onethousandsevenhundredeightyseven -- links -> threethousandfivehundredtwentyfive;
fourthousandonehundredeightyfour -- links -> twothousandonehundredeighty;
twothousandsixtyseven -- links -> two;
fourthousandsixhundredfortyeight -- links -> eighthundredfortynine;
threethousandseventyfive -- links -> threethousandonehundredfortyone;
twothousandninehundredeightyfour -- links -> fourthousandthreehundredfive;
twothousandsevenhundredtwentythree -- links -> twothousandsevenhundredeleven;
onethousandfourhundredthree -- links -> twothousandsixhundredninetysix;
eight -- links -> threehundredeighteen;
onethousandfourhundredtwentythree -- links -> twothousandninehundredforty;
fifteen -- links -> twentyfive;
threethousandonehundredeleven -- links -> onethousandtwohundredforty;
fourthousandsixhundredfortynine -- links -> onethousandsixhundredsixtynine;
onethousandsixhundredtwentynine -- links -> fourthousandtwohundredseventyfour;
fourthousandfourhundredninetyfour -- links -> onehundredtwentyfive;
twohundredthirtythree -- links -> onethousandeighthundredsixtyeight;
fourthousandninehundredsixtyseven -- links -> fourthousandonehundredseventysix;
onehundredsixtythree -- links -> onethousandfivehundredsixty;
fourthousandfivehundred -- links -> twothousandsixhundredninetytwo;
fourthousandfivehundredseventyseven -- links -> threethousandfivehundredeight;
twothousandthirtynine -- links -> onethousandonehundredeightyfive;
twothousandninehundredninetyseven -- links -> sixhundredthirteen;
onethousandsixhundredninetynine -- links -> twohundredsixtyfive;
twothousandsevenhundredtwentyseven -- links -> onethousandseven;
twothousandsixhundredthirtysix -- links -> fourthousandfourhundredsixtyseven;
fortytwo -- links -> onethousandtwohundredthirtyfour;
threethousandeighthundredninetytwo -- links -> fourhundredsixtytwo;
onethousandfivehundredfiftyseven -- links -> threethousandthreehundredsixtyone;
threethousandtwohundredfiftyfive -- links -> threethousandtwentyseven;
threehundredtwenty -- links -> twothousandfivehundredfortyeight;
twohundredtwelve -- links -> threethousandfivehundredeightyseven;
threethousandseventythree -- links -> twothousandeighthundredseventy;
twothousandfivehundredthirtyseven -- links -> fourhundredseventyone;
threethousandfivehundredthirtyeight -- links -> threethousandtwohundredeightyone;
threethousandsevenhundredseventy -- links -> threethousandthreehundredthree;
fivehundredfiftythree -- links -> fourthousandtwohundredtwelve;
threethousandtwohundredthirtyseven -- links -> threethousandten;
twothousandfivehundredninetysix -- links -> twothousandfivehundredeighteen;
twothousandsixhundredninetythree -- links -> twothousandninehundredninetysix;
threethousandsixhundredsixtytwo -- links -> onethousandsevenhundredsixtyfive;
twothousandeighthundredsixteen -- links -> twothousandonehundredsixtysix;
fourthousandtwentyseven -- links -> onethousandfivehundredthirtyfive;
threethousandsixhundredfifteen -- links -> threethousandsevenhundredfiftyeight;
threethousandthreehundredseventytwo -- links -> fourthousandsevenhundredseventy;
onethousandfourhundredfortythree -- links -> threethousandonehundredfortythree;
onethousandsixhundredfiftyfive -- links -> twothousandtwohundredthirtynine;
sevenhundredfiftyeight -- links -> threethousandtwohundredtwentyeight;
ninehundredfifty -- links -> twothousandfourhundredeight;
threethousandthirtyseven -- links -> threethousandseventyeight;
fourthousandthreehundredfiftyfour -- links -> twothousandfourhundredtwentysix;
twothousandsixhundredfortyeight -- links -> sevenhundredfortyone;
onethousandfivehundredthirtyone -- links -> fourthousandfivehundredeightytwo;
threethousandeighthundredninety -- links -> fourthousandfiftyone;
ninehundredfiftynine -- links -> twothousandonehundredfiftyfour;
fourthousandfivehundredsixteen -- links -> fourthousandfivehundredeighty;
threethousandtwohundredsixtytwo -- links -> onethousandsevenhundredeightynine;
fourthousandtwohundredseventythree -- links -> ten;
threethousandeighthundredseventy -- links -> threethousandthreehundrednineteen;
threethousandthirtyseven -- links -> threethousandninetythree;
ninehundrednineteen -- links -> fourthousandfivehundredfiftyeight;
fourthousandsevenhundredfiftyone -- links -> twothousandeighthundredtwentythree;
sevenhundredseventytwo -- links -> threethousandfourhundredthirteen;
sixhundredthirtytwo -- links -> threehundrednine;
onethousandeighthundredninetytwo -- links -> twothousandonehundredeightythree;
twothousandtwohundredeightysix -- links -> fourthousandsixhundredeightyone;
onethousandninehundredtwentyfive -- links -> twothousandthreehundredeightyfive;
fifty -- links -> twothousandthreehundredeight;
threethousandtwentyone -- links -> threethousandsixhundredthirtyeight;
ten -- links -> ninehundredeightysix;
threethousandeighthundredfour -- links -> fourthousandfivehundredeighty;
twothousandninehundredforty -- links -> threethousandthreehundredseventyfour;
fourthousandthreehundredfiftythree -- links -> threethousandninehundredninetyfive;
threethousandfourhundredfiftyseven -- links -> threethousandfivehundredsixteen;
twothousandeighthundredfortyseven -- links -> threethousandfourhundredeightysix;
threethousandninetyseven -- links -> onethousandsevenhundredsixtyfive;
threethousandtwohundredeleven -- links -> threethousandonehundredseventy;
twothousandfourhundredfiftysix -- links -> fourthousandtwohundredseventyseven;
sixhundredtwentynine -- links -> fourthousandfourhundredsixtyseven;
ninehundred -- links -> threethousandninehundredsixty;
onethousandonehundredseventyseven -- links -> eighthundredthirtyeight;
threehundredseventy -- links -> onethousandsixhundredthirtyfive;
threethousandthreehundredtwentyone -- links -> twothousandeightyone;
threethousandsevenhundredninetyseven -- links -> fourthousandseventytwo;
onethousandeighthundred -- links -> fourthousandfivehundredsixtyseven;
threethousandfivehundredtwentytwo -- links -> onehundredninetythree;
eighthundredsix -- links -> onethousandeighthundredeighty;
onethousandfivehundredeightysix -- links -> fourthousandninehundredeightynine;
sevenhundredseventynine -- links -> fourthousandfourhundredninetytwo;
onethousandeighthundredthirteen -- links -> twothousandtwohundred;
threethousandthreehundredthirtyeight -- links -> fivehundredninetytwo;
ninetyfive -- links -> onethousandthreehundredsixtyfour;
ninehundredsixtyfour -- links -> threethousandsevenhundredfortyfive;
sevenhundredseventyeight -- links -> threethousandfivehundredseventyfour;
twothousandeighthundredfiftythree -- links -> onethousandninehundredfiftyeight;
threethousandeighthundredthirtytwo -- links -> onethousandninehundredeightyeight;
fourthousandfourhundredninetyfive -- links -> twothousandsixhundredthirtyfour;
onehundredseven -- links -> threethousandfiftyeight;
onethousandfivehundredsixty -- links -> sevenhundredseventyfour;
fourthousandninehundredsixteen -- links -> fourthousandfortythree;
eighthundredninetyone -- links -> onethousandonehundredone;
fourthousandtwohundredfortyfour -- links -> threethousandsevenhundredone;
twothousandninehundredeightyfive -- links -> twothousandfourhundredtwentyfive;
threethousandthreehundredninetythree -- links -> fourhundredtwentyone;
fourthousandfourhundredsixtyfive -- links -> onethousandsixhundredfiftytwo;
fourthousandeightyeight -- links -> twothousandsevenhundredtwentyone;
fourthousandthreehundredfifteen -- links -> twothousandonehundredfiftythree;
twothousandsevenhundredseventytwo -- links -> fourthousandonehundredeightyone;
fourthousandtwohundredninetythree -- links -> threethousandninehundredeightyfour;
twothousandfivehundredtwentynine -- links -> twothousandeighthundredtwentynine;
fourthousandtwohundredsixteen -- links -> threethousandtwohundredseventytwo;
sevenhundredeightyfour -- links -> threethousandsixhundredsixtysix;
threehundredseventyeight -- links -> onethousandtwohundredseventyeight;
threethousandsevenhundredeleven -- links -> onethousandfourhundredsixtyfour;
sixhundredsixteen -- links -> onethousandfivehundredsixtyfour;
twothousandfourhundredeightythree -- links -> threethousandthreehundredfortyseven;
threethousandfourhundredeighty -- links -> threethousandfourhundredthirtyeight;
twothousandfivehundredninetyseven -- links -> fourthousandtwentyfive;
threethousandninehundredthirteen -- links -> fourthousandfortyfive;
threethousandfivehundredfiftyeight -- links -> threethousandthirtyfive;
twothousandninehundredthree -- links -> twothousandsixhundredsix;
sevenhundredfortyfour -- links -> fourthousandsevenhundredseventythree;
twothousandthreehundredfiftynine -- links -> onethousandninehundredseventythree;
onethousandtwohundredfortythree -- links -> twothousandsixhundredfortyfive;
fivehundredsixtythree -- links -> onethousandfortytwo;
fourthousandeightyone -- links -> twothousandsixhundredsixteen;
twothousandtwohundredeightytwo -- links -> twothousandtwohundredthirty;
fourthousandsixhundredthirtyone -- links -> fourthousandsixhundredeight;
onethousandsixhundredsixtythree -- links -> fourthousandninehundredfiftyone;
fourthousandonehundredsixtyeight -- links -> twothousandsevenhundredthirty;
threethousandthreehundredseventytwo -- links -> threethousandninehundredfortythree;
onethousandtwohundredthirtyone -- links -> onethousandtwohundredfiftynine;
threehundredforty -- links -> twothousandsixhundredninetyone;
fourthousandfivehundredninetytwo -- links -> twothousandthreehundredseven;
fourhundredseventyfour -- links -> fourhundredseventyone;
fourthousandtwohundredseventysix -- links -> threethousandonehundredthirteen;
twothousandtwohundredeightyone -- links -> onethousandninehundredseventyfive;
fourthousandfivehundredtwenty -- links -> onethousandthreehundredeightytwo;
sevenhundredtwentyeight -- links -> threethousandthreehundredseventysix;
twothousandeighthundredfiftyseven -- links -> threethousandfivehundredthirtyfour;
threethousandtwohundredfortyone -- links -> fivehundredninetysix;
twohundredfiftyfour -- links -> fourthousandfivehundredtwentyone;
fourthousandsevenhundredeightythree -- links -> threethousandsixtyone;
fourthousandtwohundredthirtythree -- links -> threehundredeightyfive;
fourthousandninehundredeightysix -- links -> threethousandonehundredtwentyone;
sevenhundredfiftyfive -- links -> threehundredseven;
threethousandonehundredfortyfive -- links -> twothousandsixhundredtwentyseven;
sixhundredthirtyfive -- links -> fourthousandfourhundredsixtythree;
fourthousandfourhundredfortytwo -- links -> twothousandonehundredninetyfour;
onethousandfourhundredseventyfive -- links -> twothousandsixhundredthirtyseven;
onethousandfivehundredfour -- links -> twothousandsixhundredthirtyfive;
threethousandthreehundredseventysix -- links -> onehundredninetyseven;
fourthousandsixhundredeightytwo -- links -> threethousandonehundredseventy;
threethousandonehundredsixteen -- links -> onethousandsixhundredeightyone;
seventysix -- links -> fourthousandsixhundredthirty;
threethousandonehundredfortyfive -- links -> twothousandthreehundredtwentyseven;
threehundredseventythree -- links -> eighthundredtwentysix;
threethousandsixhundredninetyone -- links -> eighthundredthirteen;
threethousandninehundredeightyeight -- links -> fivehundredfortythree;
fourthousandsevenhundredninetyfive -- links -> threethousandonehundredsixtyone;
twothousandeighthundredthirtynine -- links -> threethousandfourhundredfiftyfive;
onethousandfourhundredfortyfour -- links -> onehundredthirteen;
twothousandtwohundredseventeen -- links -> twentyeight;
fourhundredtwenty -- links -> fivehundredeightyeight;
twohundredeightyseven -- links -> threethousandtwohundredseventyone;
twohundredninetyseven -- links -> onethousandfourhundredfortyfour;
threethousandsixhundredeightyeight -- links -> fivehundredfortyone;
threethousandtwohundredseventyseven -- links -> sixhundredninetyone;
fourthousandfivehundredseventyfive -- links -> threethousandfour;
onethousandeighthundredfortyseven -- links -> fourthousandsevenhundredtwentytwo;
eighthundredsixtytwo -- links -> onethousandsixhundredtwentyseven;
fourthousandonehundredthree -- links -> fourthousandsixhundredseventeen;
fourthousandeighthundredseventythree -- links -> fourhundredthirtynine;
onethousandtwohundredfourteen -- links -> onethousandsixteen;
fourthousandfivehundredfifteen -- links -> sixhundredninetyeight;
onethousandseventytwo -- links -> sevenhundredthirtytwo;
ninehundredfiftythree -- links -> eighthundredfive;
onethousandthreehundredtwentyseven -- links -> twothousandninehundredten;
fourthousandfourhundredseventyfour -- links -> fourthousandonehundredninety;
threethousandfourhundredeightyfive -- links -> twohundredsixtynine;
onethousandninehundredeleven -- links -> onehundredfortynine;
threethousandthreehundredtwentyfive -- links -> fourhundredninetyone;
threethousandonehundredsixtyfive -- links -> threehundredninetythree;
fourthousandsevenhundredeightythree -- links -> onethousandsixhundredtwentyone;
twothousandseventyfive -- links -> twohundredtwentyfour;
ninehundredthirtyfive -- links -> threethousandninehundredninetysix;
twothousandfourhundredten -- links -> threethousandtwohundredninetyone;
threethousandfivehundredtwelve -- links -> threethousandtwohundrednine;
threethousandsevenhundredfiftythree -- links -> fourthousandthirtynine;
threehundredtwentytwo -- links -> fourthousandsixhundredfortysix;
onethousandninehundredsixtytwo -- links -> fourthousandfivehundredtwentyeight;
fourthousandthreehundredeight -- links -> onethousandtwohundredseventynine;
fivehundredfortyone -- links -> fourthousandninehundredthirtysix;
fourthousandtwohundredeightyeight -- links -> onethousandeighthundredthirtyone;
ninehundredninety -- links -> twothousandonehundredtwentysix;
fourthousandthreehundredseven -- links -> fivehundredthirtyfour;
sixhundredfive -- links -> onehundredsixtynine;
onehundredfortynine -- links -> fourthousandeighthundredeight;
twothousandninehundredfifteen -- links -> twothousandtwohundredninetynine;
fourthousandfourhundredfortythree -- links -> fourthousandninehundredfiftythree;
fourthousandonehundredfortyeight -- links -> onethousandthree;
threethousandfourhundredthirty -- links -> threehundredone;
threethousandtwohundredsixtyone -- links -> threethousandtwohundredninetyeight;
onethousandninehundredninetyone -- links -> twothousandfivehundredsixtyfour;
eighthundredtwo -- links -> onethousandfourhundredseven;
fourthousandsevenhundredfourteen -- links -> fourthousandsixhundredthirtyfour;
threethousandeightyfour -- links -> onethousandthreehundredsixtyseven;
onehundredthirtytwo -- links -> onethousandeighthundredseventyseven;
fourthousandninehundredeighteen -- links -> fourthousandonehundred;
fourthousandthreehundredthirtynine -- links -> onethousandthirtynine;
three -- links -> sevenhundredeightytwo;
onehundredsixtynine -- links -> threethousandonehundredninetysix;
threethousandeighthundredninetyfour -- links -> onethousandthreehundredsixtyseven;
threethousandsixhundredeleven -- links -> fourthousandtwohundredtwentynine;
threethousandonehundredfifty -- links -> onehundrednineteen;
fourthousandeighthundredfiftytwo -- links -> twothousandsixhundredfortythree;
fourthousandeighthundredseventyfive -- links -> onehundredtwelve;
onethousandtwohundredninetyseven -- links -> onethousandsixhundredfiftyfive;
fourthousandninehundredtwentyone -- links -> fourthousandninehundredthirtytwo;
fourthousandthreehundredthirtyseven -- links -> fourthousandninehundredeightyone;
threethousandonehundredninetytwo -- links -> twothousandthreehundredsixtythree;
threethousandtwohundredthree -- links -> fourthousandeightyone;
fourthousandtwohundredthirteen -- links -> twothousandfivehundredsixtynine;
threethousandfourhundredtwenty -- links -> onethousandthreehundredseventy;
fivehundredseventyseven -- links -> onethousandsixhundredninetytwo;
fourthousandtwohundredfiftynine -- links -> fourthousandsixhundredsixty;
fourthousandninehundredsixtyfour -- links -> eighthundredthirtyfive;
sixhundredninetynine -- links -> fourthousandfivehundredsixtytwo;
onethousandtwohundredthirtyeight -- links -> eighthundredeightynine;
fourthousandsevenhundredninetyseven -- links -> twothousandsevenhundredthree;
onethousandsixhundredsixtysix -- links -> fourthousandfiftyseven;
twothousandonehundredseventyfour -- links -> eighthundredninetythree;
twentythree -- links -> fourhundredfour;
onethousandonehundredeightyeight -- links -> twohundredfifteen;
ninehundredseventytwo -- links -> twothousandsevenhundredninety;
onethousandtwohundredninetyseven -- links -> twothousandtwohundredfiftyseven;
fourthousandninehundredeleven -- links -> twothousandeighthundredthirtyeight;
threethousandsevenhundredfourteen -- links -> fourthousandonehundredthree;
twothousandfifty -- links -> twothousandonehundredeight;
fourhundredseventyone -- links -> twohundredfortythree;
onethousandsixhundredninetyeight -- links -> twothousandfivehundredthirtythree;
onethousandonehundredninetyeight -- links -> fourthousandeighthundredthirtytwo;
twohundredfourteen -- links -> threethousandfivehundredtwentyone;
twothousandfourhundredsix -- links -> fivehundredsixtyfour;
twothousandsevenhundredfiftytwo -- links -> onethousandseventy;
fourthousandonehundredfortyone -- links -> twothousandfourhundredthirtyfour;
twothousandseventyfive -- links -> fourthousandfivehundredeightyone;
twohundredfiftyfour -- links -> onethousandonehundredone;
fourthousandsevenhundredtwentytwo -- links -> threethousandonehundredsix;
threethousandninehundredseven -- links -> onethousandsixhundredfortynine;
threethousandthreehundredfortyfour -- links -> threethousandtwentysix;
onethousandninehundredseventynine -- links -> fourhundredtwentysix;
twothousandonehundredsix -- links -> twothousandthreehundredfortynine;
twothousandsevenhundredthirteen -- links -> twothousandeighthundredforty;
threehundredeightynine -- links -> threethousandthreehundredthirty;
threehundredtwentyone -- links -> fourthousandsevenhundredtwentythree;
twothousandsevenhundredfiftyseven -- links -> threethousandfivehundredseventyeight;
threethousandtwohundredtwentytwo -- links -> onethousandfivehundredtwelve;
ninehundredsixtythree -- links -> fourthousandthreehundredfortyeight;
twothousandfiftythree -- links -> fourthousandonehundredfifty;
fourthousandfivehundredthirty -- links -> twothousandeighthundredeight;
onethousandonehundredeightyfour -- links -> fourthousandninehundredseventy;
threethousandeighthundredeightysix -- links -> onethousandsevenhundredninetyone;
fivehundredninetytwo -- links -> onethousandsevenhundredfiftyeight;
fortyone -- links -> threethousandninehundredninetynine;
onethousandtwohundredseventyfour -- links -> fourthousandsevenhundredfortyfour;
onethousandonehundredtwentythree -- links -> fourthousandfivehundrednine;
threethousandfiftytwo -- links -> fourthousandfivehundredseventyfour;
twothousandfivehundredfifty -- links -> fourthousandonehundredfiftyfive;
fourthousandeighthundredsixtyone -- links -> onethousandfivehundredfour;
twothousandsixty -- links -> onethousandeighthundredone;
sevenhundredninety -- links -> fourthousandthreehundredsixtysix;
ninehundredtwentyfive -- links -> threethousandthreehundredeleven;
onethousandeighthundredeightynine -- links -> fortyeight;
eighthundredninetysix -- links -> fourthousandfourhundredfortyone;
twothousandsevenhundredforty -- links -> threethousandninetythree;
threethousandfortyfive -- links -> fourthousandthreehundredfifteen;
threehundredtwentytwo -- links -> threethousandseventyfour;
twothousandsevenhundredfiftyseven -- links -> twothousandeighthundredseventysix;
onethousandsixhundredfifteen -- links -> twothousandfortyfour;
threethousandeightyseven -- links -> fourthousandfivehundredninetyone;
threethousandtwentynine -- links -> fourthousandeighthundredthirtythree;
onethousandfivehundredtwenty -- links -> twothousandsixhundredninetynine;
fourthousandfivehundrednineteen -- links -> threethousandfourhundredeightynine;
sevenhundredninety -- links -> eighthundredseventyseven;
onethousandsevenhundredthirtyeight -- links -> twothousandtwohundredseventyfour;
onethousandsixhundredsixtyfive -- links -> sixhundredsixty;
fourthousandseventyfive -- links -> twothousandninehundredtwentyeight;
threethousandeighthundredsixtythree -- links -> fourthousandtwohundredeighteen;
onethousandsevenhundredfive -- links -> twothousandtwohundredsixty;
onethousandninetyeight -- links -> threethousandtwohundredtwentysix;
fivehundredeightyfour -- links -> onethousandfourhundredeleven;
fourthousandtwohundredeighty -- links -> threethousandonehundredsixteen;
onethousandsixhundredseventynine -- links -> sevenhundredsixtyeight;
fourthousandsevenhundredseventyfour -- links -> ninehundredfiftyeight;
onethousandonehundredeleven -- links -> threethousandtwohundredsixtyeight;
fivehundredeightyfive -- links -> onethousandeighthundredseventyseven;
onethousandonehundredthirtysix -- links -> fivehundredsixty;
threethousandthreehundredseventytwo -- links -> onethousandonehundredninetythree;
ninehundredthirtyseven -- links -> fourthousandninehundredseventeen;
fourthousandninehundredninetynine -- links -> threethousandsixhundredfourteen;
onethousandsixhundredfour -- links -> fourthousandeighthundredfortythree;
twothousandthreehundredfourteen -- links -> onethousandfivehundredtwentysix;
onehundredeightyeight -- links -> twothousandsevenhundredeighteen;
six -- links -> threethousandninehundredthirtytwo;
sixhundredeleven -- links -> threethousandfivehundredthirtyfive;
twothousandtwohundredeightyfour -- links -> twohundredthirtysix;
onethousandninehundredthirtythree -- links -> onethousandsixhundredtwentythree;
onethousandninehundredtwentyfour -- links -> twothousandeighthundredseventyone;
threethousandthreehundredeightyseven -- links -> threethousandthreehundredthirtyfour;
onethousandtwenty -- links -> threethousandninehundredtwentytwo;
twothousandtwelve -- links -> onethousandfourhundredfiftyseven;
fourthousandsixhundredthirtyfive -- links -> eighthundredfive;
fourhundredseventyeight -- links -> twothousandtwohundredninetyseven;
twothousandfourhundredone -- links -> twothousandsevenhundredfiftythree;
threethousandsixhundredsixtynine -- links -> fivehundredfortyfour;
threethousandsixhundredninetythree -- links -> threethousandthree;
fourthousandsevenhundredeighteen -- links -> sixhundredtwentythree;
threethousandfourhundredthirtyfour -- links -> onethousandsevenhundredone;
threethousandonehundredseventynine -- links -> threehundredfortyseven;
onethousandfivehundredfortythree -- links -> fourthousandfourhundredseventysix;
fourthousandonehundredsixteen -- links -> fivehundredninetyeight;
twohundredfifty -- links -> threethousandsixhundredsixty;
onethousandninehundredninetyseven -- links -> onethousandsixhundredseventyfour;
twothousandsixhundred -- links -> fourthousandthreehundredninetynine;
threethousandninehundredeightyfive -- links -> twothousandthreehundredeightyfour;
fourthousandtwohundredeightythree -- links -> fourhundredfortyfour;
ninehundredthirtyone -- links -> ninetyfive;
fiftyseven -- links -> twothousandsixhundredtwenty;
fourthousandtwohundredfiftythree -- links -> fourthousandthreehundredtwelve;
twothousandsixhundredfiftythree -- links -> fourhundredthirtythree;
fourthousandonehundredtwenty -- links -> threehundredfortyone;
fourthousandfivehundredfiftysix -- links -> onethousandfourhundredseventynine;
fivehundredten -- links -> sixtysix;
threethousandsixhundredfortysix -- links -> onethousandsevenhundredeighty;
onethousandonehundredfiftynine -- links -> onethousandninetytwo;
twohundredninetyfour -- links -> onethousandfivehundredsixteen;
fourthousandsixhundredthirty -- links -> onethousandthreehundredsixtyfive;
onehundredsixty -- links -> onethousandonehundredsixteen;
twothousandsixhundredseventyone -- links -> twothousandfourhundredfifty;
fivehundredsixtysix -- links -> sevenhundredtwelve;
threethousandfivehundredtwentyseven -- links -> twothousandfivehundredtwentyfour;
twothousandfourhundredsixteen -- links -> fourthousandsixhundredfortynine;
fourthousandonehundredfour -- links -> twothousandtwohundredfifty;
twothousandfivehundredsixtysix -- links -> threethousandtwohundredsix;
sevenhundredfiftytwo -- links -> threethousandninehundredninetytwo;
fourthousandfivehundredsixtytwo -- links -> onethousandsixhundredninetynine;
fourthousandthreehundredfiftyseven -- links -> threethousandfourhundredone;
fourthousandfourhundredeightyseven -- links -> fivehundredninetyone;
fourthousandeighthundredninetyfive -- links -> threethousandsevenhundrednineteen;
threethousandsevenhundredseventysix -- links -> fivehundredeleven;
twothousandtwohundredone -- links -> onethousandfourhundredeleven;
onethousandeighthundredfourteen -- links -> threethousandsixhundred;
twohundredseventyseven -- links -> threethousandninehundredninetytwo;
onethousandsixhundredtwentysix -- links -> twothousandsevenhundredtwentytwo;
ninehundredforty -- links -> twothousandninehundredtwentytwo;
onethousandthreehundredthirtyone -- links -> fourthousandtwohundredthirtyone;
twothousandfivehundredthree -- links -> onethousandfourhundredthirtysix;
twothousandsixtyone -- links -> twothousandfivehundredsixtythree;
fourthousandsevenhundredthirtyfour -- links -> twothousandthreehundredeleven;
onethousandthreehundredsixtyseven -- links -> onethousandsevenhundredseventyfour;
fourthousandeighthundredfortytwo -- links -> threehundredfiftyeight;
twohundredseventy -- links -> threethousandsixtyone;
fourthousandonehundredtwenty -- links -> threethousandfivehundredfifty;
onethousandthreehundredfortyseven -- links -> ninehundredninetyeight;
fourthousandfourhundredfortyfour -- links -> threethousandninehundredseventyone;
onethousandonehundredfiftyseven -- links -> onethousandninehundredfiftyfour;
fourhundredseven -- links -> eighthundredninetyfour;
fivehundredseventeen -- links -> fourthousandninehundredfortyone;
fourthousandfourhundredthirtynine -- links -> sevenhundredfifteen;
fiftythree -- links -> onethousandthreehundredseventysix;
ninehundredfiftyfour -- links -> threethousandninehundredeightytwo;
fivehundredseventyone -- links -> twothousandsevenhundredtwentyeight;
twothousandonehundredeightythree -- links -> fourthousandonehundredfortynine;
eighthundred -- links -> twothousandsixhundredseven;
fourhundredfortynine -- links -> fourthousandfourhundrednine;
threethousandsevenhundredninetynine -- links -> threethousandsevenhundredthirtyseven;
onethousandtwohundredfortyeight -- links -> threethousandsixhundredeightysix;
threethousandsixhundredeightyfour -- links -> fourthousandsevenhundredthirteen;
threethousandfourhundredsixtytwo -- links -> fourthousandsixhundredninety;
threethousandtwohundredseventyfive -- links -> onethousandfortyone;
threethousandeighthundrednineteen -- links -> twothousandten;
sixhundredseventyfour -- links -> twothousandfortynine;
fourthousandthreehundredthirtythree -- links -> fourthousandthreehundredseventysix;
sevenhundredsixteen -- links -> fourthousandonehundredten;
threethousandeighthundredtwentythree -- links -> threethousandsevenhundredthirteen;
fourthousandfivehundredeightyseven -- links -> twothousandonehundred;
twothousandninetythree -- links -> onethousandonehundredfortyseven;
twothousandfourhundredeightyone -- links -> onehundredfiftyeight;
twothousandthreehundredsixtyone -- links -> eighthundredfiftyone;
onethousandeleven -- links -> onethousandonehundredtwentytwo;
threehundredninetyseven -- links -> threethousandsixhundredninetytwo;
fourthousandninehundredthirtynine -- links -> onethousandsixhundredtwentysix;
onethousandsevenhundredten -- links -> sevenhundredseventytwo;
eighthundredninetysix -- links -> fourthousandsixhundredthirteen;
eighthundredtwentysix -- links -> threethousandtwohundredeight;
fourthousandsevenhundredeight -- links -> threethousandninehundredforty;
twothousandfourhundredseventy -- links -> threethousandfivehundredeightyfour;
fourthousandonehundredthirty -- links -> sevenhundredtwentyseven;
onethousandthreehundredeightyone -- links -> twothousandfourhundredfourteen;
onehundredseventyeight -- links -> onethousandfourhundredsixteen;
onethousandsevenhundredthirtyseven -- links -> threethousandeighthundredseventynine;
threethousandtwohundredeightytwo -- links -> fourhundredeighty;
twothousandonehundredsixtyseven -- links -> onethousandonehundredninetysix;
sevenhundredthirtyeight -- links -> fourthousandsevenhundredfortytwo;
onethousandfourhundredsixtyseven -- links -> onethousandninehundredninetyfour;
fourthousandninehundredeightyeight -- links -> thirtyeight;
twothousandeighthundredsixtythree -- links -> twothousandeighthundredfive;
sixhundredseven -- links -> fourthousandsixhundredsixtytwo;
onethousandonehundredthirteen -- links -> twothousandsixhundredfiftynine;
fourthousandfivehundredthirtyfive -- links -> onethousandsixhundredtwentyseven;
fourthousandfourhundredsixtyfour -- links -> twothousandtwohundredeightyfive;
threethousandeightytwo -- links -> twothousandsevenhundredfortysix;
eighthundredthirtyfour -- links -> threehundredeightyfive;
onethousandfourhundredninetyseven -- links -> fourthousandthreehundredseventyeight;
onethousandthreehundredthirtyfour -- links -> fourthousandtwohundredtwentysix;
fourhundredone -- links -> threethousandeighthundredtwentythree;
threethousandtwohundredfiftysix -- links -> twohundredfiftyseven;
twothousandfivehundredsixtyfive -- links -> onethousandninehundredthirty;
onethousandninetyfive -- links -> twothousandtwentyone;
twothousandeighthundredeighteen -- links -> fourthousandthreehundredfiftyfive;
threethousandninehundredfiftyone -- links -> fourthousandsixhundredfiftythree;
onethousandtwohundredthirty -- links -> threethousandtwohundredfortyone;
twothousandfivehundredtwentythree -- links -> fourthousandninehundredninetyone;
onethousandsixhundredseventyeight -- links -> threethousandsevenhundredninetytwo;
twothousandeightythree -- links -> twothousandsixhundredone;
fourthousandfourhundredeleven -- links -> fivehundredthirtyseven;
onethousandonehundredeightyone -- links -> onethousandonehundredeight;
onethousandfourhundredsixteen -- links -> onehundredfiftyone;
threethousandninetyone -- links -> onethousandthreehundredfour;
onethousandeighthundredthirtyfive -- links -> onethousandtwentyone;
fourthousandsixhundrednine -- links -> twothousandtwohundredthirtyfour;
fourthousandfourhundredfive -- links -> twothousandsevenhundredthirtyfour;
threethousandonehundredseventy -- links -> fourthousandsixhundredeightythree;
twothousandfivehundredsixtyeight -- links -> threethousandsevenhundred;
onethousandninehundredninety -- links -> twothousandthreehundredfiftyfour;
twothousandfivehundredeightyeight -- links -> twothousandsixhundredninety;
fourthousandtwohundredeighteen -- links -> fourthousandten;
twothousandthreehundredninetyeight -- links -> sixhundredfive;
threethousandtwohundredtwenty -- links -> ninehundredtwentysix;
fourthousandfivehundrednine -- links -> fourthousandthreehundrednine;
fourhundredfortyeight -- links -> fivehundredthirtysix;
sixhundredtwentysix -- links -> onethousandfivehundredtwentyone;
onethousandonehundredsixteen -- links -> threethousandsixhundredeightyone;
twohundredthirtyfive -- links -> sixhundredforty;
threehundredfiftyseven -- links -> twothousandeighthundredthirtyfour;
twothousandeighthundredfiftytwo -- links -> twenty;
onethousandfourhundredtwentyeight -- links -> onethousandsevenhundredsixtynine;
fourthousandninehundredeight -- links -> twohundredsixtyfive;
threethousandonehundredthirteen -- links -> onethousandfivehundredsixty;
twothousandsevenhundredeleven -- links -> twothousandthreehundred;
ninehundredseventyeight -- links -> twothousandonehundredtwentyeight;
fourthousandsevenhundredeightyone -- links -> threethousandsixhundredseventy;
onehundredthirtysix -- links -> threethousandsixhundredfiftynine;
threethousandsixhundredthirty -- links -> sixhundred;
fourthousandninehundredseventyfour -- links -> fourhundredfourteen;
ninehundredfour -- links -> threethousandonehundredtwenty;
twothousandsixhundredeightysix -- links -> threethousandsevenhundredfortynine;
onethousandsixhundredfifteen -- links -> twothousandsevenhundredtwentyone;
sixhundredseventyfour -- links -> twothousandninehundredfiftytwo;
threethousandeighthundredeightyseven -- links -> threehundredtwentynine;
onethousandthreehundredeightyeight -- links -> onethousandninetynine;
onethousandsixhundredseventeen -- links -> onethousandtwohundredsixtyseven;
twothousandfiftynine -- links -> twothousandthreehundredeighty;
threethousandtwohundredthirtytwo -- links -> onethousandninehundredone;
twothousandfourhundredtwentysix -- links -> onethousandsixhundredthirteen;
twothousandsixhundredseven -- links -> fourthousandseventyseven;
onethousandninehundredninetynine -- links -> fourthousandsevenhundredfiftyfour;
fourthousandfourhundredninetysix -- links -> threethousandfivehundredtwentyfour;
threethousandninehundredone -- links -> onethousandonehundredseventytwo;
threethousandeighthundredseventyfive -- links -> threethousandthreehundredninetysix;
threethousandtwohundredseventy -- links -> onehundredeight;
twothousandeighthundredfortytwo -- links -> onethousandeighthundredthirtyeight;
onethousandfivehundredtwenty -- links -> eighthundredthree;
threethousandfourhundredthirty -- links -> onethousandfivehundredninetysix;
twohundredsixtysix -- links -> fourhundredseventyeight;
threethousandeightyseven -- links -> sevenhundredeightyone;
threethousandonehundredeighty -- links -> twothousandsevenhundredfiftyone;
fivehundredforty -- links -> fourthousandfourhundredthirtynine;
twothousandseventeen -- links -> twothousandfourteen;
onethousandsevenhundredtwentyfive -- links -> fourthousandonehundredeighteen;
fourthousandfivehundredfiftyfour -- links -> fourthousandtwohundredninetyfive;
twothousandfourhundredtwo -- links -> threethousandninehundredsix;
twothousandsevenhundredfiftyone -- links -> twothousandfiftytwo;
onethousandninehundredfiftyfive -- links -> threethousandtwohundredseventynine;
threehundredsixteen -- links -> onethousandfivehundredfortyseven;
twothousandfifty -- links -> twothousandfivehundredfortythree;
twothousandfivehundredseventyfive -- links -> twothousandthreehundredfifteen;
sixhundredeighty -- links -> fourthousandeighthundredtwo;
fourthousandfifty -- links -> threehundredfour;
onehundredeightyseven -- links -> fourthousandsixhundredthirtyseven;
twothousandninehundredfive -- links -> onethousandfourhundredsix;
onethousandfortynine -- links -> sixhundredforty;
fourhundredthirtythree -- links -> onethousandfourhundredtwentyfive;
onehundredseventynine -- links -> threethousandfivehundredthirtyeight;
onethousandfivehundredninetyfour -- links -> onethousandeighthundredfiftyone;
threethousandtwohundredsixtyfive -- links -> onethousandninetyfive;
eighthundredeleven -- links -> onethousandfourhundredsixtythree;
twohundredsix -- links -> twothousandfivehundredeightyfive;
onethousandfortynine -- links -> threethousandtwohundredsixtyseven;
twothousandfivehundredsixty -- links -> fourthousandeighthundredsixty;
threethousandtwohundredfortythree -- links -> fourthousandninehundredfiftyfour;
fourthousandninehundredeightytwo -- links -> twothousandnineteen;
onethousandthreehundredtwentyfive -- links -> fourhundredninetyfive;
fourthousandseventy -- links -> onethousandsixhundredninetyseven;
onethousandonehundredfortythree -- links -> threethousandfourhundredseventy;
twothousandninetyeight -- links -> fourthousandonehundredtwentytwo;
fourthousandtwohundredfortytwo -- links -> ninehundredforty;
onethousandonehundredten -- links -> twothousandonehundredeightyfour;
twothousandthreehundredthirtyfour -- links -> fourthousandninehundredfiftyone;
fourthousandeighthundredeightyone -- links -> onehundredsixtyone;
threehundredthirtynine -- links -> threethousandsevenhundredthirtyfive;
onethousandonehundredfifty -- links -> eighthundredsixtyone;
twothousandfourhundredtwo -- links -> onethousandsixhundredtwelve;
threehundredtwo -- links -> fourthousandeightyfive;
twothousandsevenhundredten -- links -> fourthousandfourhundredthirtyfour;
twothousandsevenhundredfortyseven -- links -> eighthundredfortyseven;
fourthousandfiftythree -- links -> threethousandthreehundredtwentyseven;
twothousandsevenhundredsixtythree -- links -> onethousandninehundredeightytwo;
sixtynine -- links -> onethousandsixhundredsixtyone;
twohundredseventynine -- links -> fourthousandonehundredfiftyeight;
twothousandsixtyone -- links -> threethousandsevenhundredsix;
sevenhundredfortythree -- links -> twothousandthreehundredninetyeight;
onethousandninehundredfiftythree -- links -> fourthousandsixhundredfortyfour;
twothousandfivehundredfortynine -- links -> ninehundredsixtysix;
onethousandonehundredninetythree -- links -> twothousandsevenhundredseven;
threethousandfourhundredninety -- links -> threethousandninehundredthirtysix;
threethousandfivehundredsixtyseven -- links -> twothousandfivehundredninetyone;
threethousandsevenhundredninetytwo -- links -> fourthousandsevenhundredseven;
twothousandfivehundredseven -- links -> twothousandfivehundredtwentyeight;
onethousandsixhundredeightysix -- links -> twothousandeighthundredsixtysix;
threethousandonehundredeight -- links -> twothousandninehundrednine;
threethousandeighthundredfortynine -- links -> twothousandtwohundredninetynine;
onethousandninehundredone -- links -> threehundred;
fourthousandonehundredtwentyfive -- links -> twothousandonehundredeightyseven;
threethousandfourhundredninetyeight -- links -> onethousandsixhundredeightyseven;
twothousandfivehundredtwentyeight -- links -> sixhundredtwentytwo;
fourthousandfivehundredtwentysix -- links -> fourthousandonehundredsixtyeight;
twothousandtwohundredseven -- links -> onethousandonehundredninetyseven;
onethousandthreehundredfifteen -- links -> threehundredfiftyfive;
threethousandninehundredsixty -- links -> onethousandfourhundredsixtyfive;
twothousandonehundredsixtyfour -- links -> threethousandsixhundredten;
onehundredninetyfour -- links -> twothousandninetyone;
threethousandeighthundredtwentysix -- links -> fourthousandsixhundredseventyeight;
onethousandfivehundredfiftyseven -- links -> onethousandthirtyeight;
threethousandfivehundredfive -- links -> fourthousandninetysix;
onethousandfourhundredfifty -- links -> sixhundredfortyfour;
twothousandninehundredfiftynine -- links -> twothousandninehundredthirtysix;
threehundredninety -- links -> onethousandfivehundredninetysix;
twothousandthreehundredsixtyone -- links -> onethousandeighthundredseventyseven;
twothousandfiftyseven -- links -> threethousandtwentynine;
onehundredfive -- links -> fourthousandonehundredthirtynine;
fourthousandfivehundredone -- links -> fourthousandtwohundredtwentyone;
fourthousandfourhundredninetyfive -- links -> twothousandonehundredninetyfive;
threethousandthreehundredninetyseven -- links -> twothousandtwohundredfiftynine;
sixhundredfiftynine -- links -> onethousandsixhundredthirtysix;
fourthousandonehundredfiftyfive -- links -> twothousandonehundredsixtytwo;
threethousandeighthundredeightyfive -- links -> threethousandtwentythree;
twothousandfivehundredninetyeight -- links -> twothousandfivehundredfifty;
sevenhundredfortyfive -- links -> twothousandthreehundredtwelve;
twothousandninehundredeightythree -- links -> twothousandthreehundredsixtyone;
threethousandthreehundredthirty -- links -> onethousandeighthundredthirtytwo;
fourthousandeighthundredthirtyeight -- links -> threethousandsixhundredtwentytwo;
fiftyeight -- links -> onehundredfiftytwo;
fortysix -- links -> fourthousandfourhundredfifteen;
threethousandtwohundredseventyfive -- links -> fourthousandninehundredtwenty;
twothousandfourhundredtwentyfive -- links -> threethousandninehundredeightysix;
onethousandsixhundredsixtynine -- links -> fourthousandfivehundredeightyone;
threethousandtwohundredsixtyfive -- links -> onethousandsixhundredtwentytwo;
twenty -- links -> fourthousandonehundredsixtyeight;
twothousandsevenhundrednine -- links -> twohundredseventyfive;
threethousandfivehundredfiftyseven -- links -> eleven;
twohundredtwentyeight -- links -> onehundredfiftytwo;
onethousandninehundredfiftyeight -- links -> fourthousandsevenhundredsixty;
threethousandthreehundredfour -- links -> onethousandonehundredfiftyeight;
threethousandonehundredtwentyseven -- links -> fourthousandtwohundredninetyeight;
onethousandfourhundredtwo -- links -> threethousandsevenhundredtwentynine;
fourthousandsixhundredfiftyseven -- links -> fourthousandtwohundredfour;
twothousandfourhundredfortyseven -- links -> onethousandseventy;
onethousandeightyone -- links -> threethousandfourhundredeighty;
threethousandfourhundredfortyfour -- links -> twothousandfourhundredeight;
fourthousandfivehundredtwelve -- links -> threethousandsixhundredfortyseven;
threethousandninehundredfifteen -- links -> fourhundredeightyfive;
threehundredseventy -- links -> twothousandfortyseven;
onethousandsevenhundredthirtyseven -- links -> twothousandthreehundredfortytwo;
threethousandfifty -- links -> fourthousandthreehundredninetysix;
onethousandfourhundredfiftyone -- links -> onethousandsixhundredeleven;
twothousandfivehundredeighteen -- links -> twothousandfivehundredseventeen;
threethousandtwohundredfiftythree -- links -> fourthousandthreehundredsixtyfour;
onethousandfivehundredeightyeight -- links -> fourthousandsevenhundredeleven;
threehundredfiftyeight -- links -> fourthousandsevenhundredtwentyfive;
onethousandsevenhundredtwentynine -- links -> threethousandsevenhundredsixtyseven;
fourthousandfourhundredfiftynine -- links -> threethousandtwohundredfortynine;
fourthousandonehundredsixtynine -- links -> threethousandeighthundred;
onethousandsevenhundredninetynine -- links -> onehundredseventyfive;
fourhundredone -- links -> twenty;
onethousandfivehundredseventytwo -- links -> onehundredfortysix;
threethousandninehundredninetysix -- links -> fourthousandfivehundredthree;
twothousandsevenhundredtwentynine -- links -> eighthundredeightytwo;
twothousandfourhundredninetythree -- links -> fivehundredninetynine;
fourthousandninehundredsixty -- links -> fourthousandsixhundredeightyeight;
fourthousandsevenhundredeightysix -- links -> threethousandseventytwo;
onehundredfortyseven -- links -> onethousandsixhundredninetyfour;
seventyfour -- links -> onethousandonehundredfortyone;
threethousandsevenhundredthirtyeight -- links -> sixhundredthirteen;
threehundredsixtythree -- links -> onethousandfortynine;
sevenhundredeightyseven -- links -> fourthousandonehundredfiftytwo;
onethousandfortytwo -- links -> twothousandonehundredthirtynine;
ninehundredten -- links -> twothousandtwohundredeightysix;
threethousandsevenhundredtwenty -- links -> twothousandtwohundredseventynine;
twothousandtwelve -- links -> fourhundredeightyfive;
onehundredeightynine -- links -> threethousandsixhundredeighty;
threethousandninehundredseventytwo -- links -> sixtysix;
twothousandninetynine -- links -> twothousandninehundredsixtyfour;
threehundredsixtynine -- links -> onethousandninehundredninetyseven;
threethousandninehundredthirtyeight -- links -> sevenhundredthirtyseven;
ninehundredthirtytwo -- links -> fourthousandsixhundred;
twothousandsixhundredthirtyfive -- links -> fourthousandsevenhundredfiftyfive;
onehundredninetythree -- links -> twothousandthreehundredsixtyeight;
fourthousandninehundred -- links -> onethousandsixhundredthirtynine;
onethousandsixhundred -- links -> fourthousandsevenhundredtwentyfive;
twothousandeighthundredeightyseven -- links -> ninehundredtwentynine;
threethousandonehundredthirtyone -- links -> twothousandeighthundredthirtysix;
onethousandsevenhundredfiftynine -- links -> onethousandfivehundredsixtytwo;
onethousandsixhundredseventynine -- links -> threethousandsixhundredseventyfive;
twothousandfivehundredfour -- links -> sixhundredfiftyfour;
fivehundredthirtyseven -- links -> ninehundredeighty;
fourthousandeighthundredthirtythree -- links -> threethousandsixhundredeightynine;
threethousandfiftyfour -- links -> onehundredninetyfive;
fourthousandthreehundredtwentynine -- links -> onethousandonehundredthirty;
fourthousandninehundredfifty -- links -> threethousandtwohundredseventythree;
onethousandsevenhundredeightyseven -- links -> fourthousandfivehundredfortythree;
twothousandninehundredfortythree -- links -> fourthousandsevenhundredseventyone;
twothousandonehundredeightyfour -- links -> fourthousandtwohundredninetysix;
twothousandtwentysix -- links -> threethousandthreehundredtwentyfive;
threethousandthirtytwo -- links -> sevenhundredtwenty;
fourthousandfivehundredthirtyone -- links -> fourthousandsevenhundredeightyfour;
twothousandsevenhundredthirtytwo -- links -> fourthousandsevenhundrednine;
twothousandtwo -- links -> onethousandfourhundredninetynine;
threethousandsevenhundredtwentythree -- links -> twothousandfourhundredone;
fourthousandfivehundredfortyfive -- links -> thirtyseven;
twothousandfourhundredeightysix -- links -> fourthousandonehundredsixtynine;
twothousandfifty -- links -> fourthousandtwentyfour;
twothousandonehundredseventyeight -- links -> twothousandtwohundredfiftyeight;
twohundredseventynine -- links -> fourthousandsixtyfive;
threethousandsixtysix -- links -> onethousandthreehundredsixteen;
fourthousandonehundredseventeen -- links -> threethousandfivehundredfiftysix;
fourthousandninehundredeightythree -- links -> onehundredfiftynine;
twothousandeighthundredtwentyone -- links -> fourthousandtwohundredthirtyseven;
threethousandthreehundredfortynine -- links -> twothousandonehundredninetyfour;
onethousandsixhundred -- links -> twothousandninehundredsixtyone;
onethousandtwo -- links -> onehundredseventyeight;
fourthousandseven -- links -> twothousandthree;
threethousandtwohundredfiftyfour -- links -> fourthousandfourhundredninetyfive;
threethousandninehundredtwentyfive -- links -> sevenhundredthirtyeight;
fourthousandeighthundredfortytwo -- links -> fourthousandtwohundredthree;
twothousandsixhundredeightyone -- links -> threethousandsevenhundredfiftytwo;
twothousandonehundredthirtyfour -- links -> onethousandfivehundredsixtythree;
twothousandtwohundredfiftyone -- links -> twothousandthreehundredfiftyseven;
fourthousandeighthundredninetyone -- links -> threethousandeighthundredeightyeight;
threethousandthreehundredthirty -- links -> fourthousandsevenhundredsixtytwo;
twothousandsevenhundredtwentytwo -- links -> twothousandfivehundredninetynine;
onethousandfourhundredninetysix -- links -> threethousandninehundredthirteen;
onethousandfivehundredeightythree -- links -> threethousandsevenhundredfiftysix;
onethousandtwohundredtwentyseven -- links -> threethousandninehundredthirteen;
fourthousandsevenhundredninetyseven -- links -> threethousandsixhundredthirtyeight;
threethousandtwohundredfiftyseven -- links -> threethousandthirtytwo;
fourhundredtwentythree -- links -> fourthousandfivehundredthirtyone;
threethousandeighthundredseventyone -- links -> onethousandninehundredtwentyone;
fourthousandsixhundredfiftyseven -- links -> onethousandeighthundredfortyfour;
twothousandsixhundredthirty -- links -> twothousandfivehundredsixtysix;
fourthousandsixhundredseventythree -- links -> threethousandonehundredninetysix;
twothousandsixhundredthirtyfive -- links -> twothousandfourhundredthirtynine;
fourthousandtwohundredtwentyone -- links -> eighthundredtwentysix;
threethousandsixhundredeightyone -- links -> fourthousandthreehundrednineteen;
fivehundredfortyfive -- links -> threehundredone;
threethousandsevenhundredninetysix -- links -> onethousandonehundredfiftyone;
twothousandfivehundredninetyseven -- links -> sevenhundredeightythree;
onethousandsixhundredthirtyseven -- links -> threethousandeighthundredninetytwo;
nine -- links -> threethousandninehundredfiftyfour;
onethousandninehundredfiftyseven -- links -> onethousandninehundredforty;
threethousandeighthundredeightysix -- links -> fourthousandsixhundredsixtyfour;
fourthousandeight -- links -> threethousandfourteen;
onethousandtwohundredfiftyone -- links -> onethousandseven;
onethousandtwentyfour -- links -> sevenhundrednineteen;
onethousandeighthundredeight -- links -> eighthundredsixtyfour;
twothousandtwohundredsixtyseven -- links -> threethousandthreehundredthirteen;
threethousandfivehundredfiftyfive -- links -> twothousandsevenhundredtwentyeight;
twothousandsixhundredfortytwo -- links -> onethousandtwohundredthirty;
threethousandfourhundredtwelve -- links -> threethousandninehundredtwenty;
onethousandninehundredeightytwo -- links -> threethousandfivehundredninetyfour;
twothousandsixhundredthirtynine -- links -> threethousandsevenhundredeightythree;
thirtythree -- links -> fifteen;
threethousandthirty -- links -> sevenhundredeightyfour;
twothousandfivehundredfortytwo -- links -> threethousandtwohundredeightynine;
fourthousandonehundredsixtyeight -- links -> fourthousandonehundredfifty;
onethousandseven -- links -> fourthousandsixhundredeightynine;
twothousandsevenhundredsix -- links -> threethousandeighthundredninetyone;
fourthousandfourhundredsixtyfive -- links -> fourthousandsevenhundredfortyfour;
sixhundredeightyone -- links -> threethousandfourhundredforty;
twothousandeighthundredseventy -- links -> fourthousandfivehundredsixtyone;
sixhundredone -- links -> twothousandtwohundredtwentythree;
fourthousandsixhundredfiftyfour -- links -> threethousandthreehundredsixtynine;
eighthundredeightyfour -- links -> threethousandeighthundredeightyfour;
twothousandfivehundredfiftyfive -- links -> twothousandsevenhundredfourteen;
fourthousandsixhundredninety -- links -> onethousandninehundredthirty;
twothousandeighthundredthirtytwo -- links -> sevenhundredsix;
threethousandonehundredseventy -- links -> threethousandeighthundredfifty;
twothousandsevenhundred -- links -> twothousandtwohundredfortythree;
twothousandsixhundrednineteen -- links -> twothousandfourhundredthirtyseven;
onethousandsixhundredeightynine -- links -> threehundredeight;
onethousandthreehundredthirtyseven -- links -> onethousandfourhundredsixtyseven;
twothousandeighthundredeightyfour -- links -> threethousandthreehundredninetyseven;
twothousandsixhundredthirtyone -- links -> fourthousandeightyfour;
fourthousandfortynine -- links -> twothousandonehundredsixtyeight;
threethousandeighthundredthirtyseven -- links -> onethousandsevenhundredseventytwo;
threehundredeightyeight -- links -> fourthousandeighthundredsixtysix;
fourthousandninehundredthirtyfour -- links -> fourthousandsevenhundredthirtytwo;
ninehundredthirtythree -- links -> onethousandsevenhundredninetytwo;
twothousandfivehundredeightyfive -- links -> onethousandthreehundredthirtynine;
threethousandsixhundredeightynine -- links -> threethousandsixhundredseventyone;
twohundredtwo -- links -> twothousandninehundredfiftysix;
twothousandeighthundredthirtyfour -- links -> threehundredeightyeight;
onethousandonehundredfortyone -- links -> fivehundredsixty;
threethousandsevenhundredtwentythree -- links -> twothousandsixhundredfortytwo;
fourthousandsix -- links -> threethousandsevenhundredtwentyfour;
ninehundredninetythree -- links -> twothousandtwohundredseventythree;
threethousandtwohundredsixtythree -- links -> threethousandeightyfive;
threethousandninehundredseventyseven -- links -> onethousandeighthundredsixtyseven;
threethousandsevenhundredfortythree -- links -> onethousandfivehundredeightyfour;
threethousandninety -- links -> onethousandsevenhundredeightyseven;
twothousandsevenhundredninetyfive -- links -> fourthousandninetyfour;
fourthousandeighthundredfiftyfive -- links -> threehundredninetyone;
fourthousandtwohundredsixty -- links -> fourthousandfourhundredfortyfour;
onethousandonehundredeightyeight -- links -> threethousandthreehundred;
threethousandsixhundredsixtytwo -- links -> onethousandonehundredfiftythree;
threethousandninehundredthirtyseven -- links -> fourhundredtwentyfour;
onethousandninehundredfortyfour -- links -> threethousandonehundredtwentynine;
eighthundred -- links -> fourthousandeighthundredeightytwo;
onethousandfivehundredfortyeight -- links -> sixhundredthirtyone;
threethousandthreehundredtwentyseven -- links -> twothousandfourhundredfortysix;
twothousandtwohundredtwenty -- links -> twothousandseven;
threethousandninehundredseven -- links -> fourthousandsixhundredtwenty;
onehundredfiftyone -- links -> twothousandeighthundredforty;
twothousandsixhundredthirtythree -- links -> threethousandonehundredsixtyeight;
twothousandthreehundredfiftynine -- links -> threethousandsixhundredseventythree;
fourhundredfortytwo -- links -> onethousandfivehundredseventythree;
twothousandfivehundredtwentyeight -- links -> sixhundredfiftyone;
onehundredeightysix -- links -> threethousandthreehundredfortyseven;
twohundredseventytwo -- links -> threethousandthreehundredsixtythree;
fourthousandninehundredfortyone -- links -> fourthousandonehundredeightythree;
fourthousandfive -- links -> threethousandthreehundredninetyfive;
twothousandsevenhundredninetynine -- links -> threethousandsixhundredeightynine;
fivehundredeightythree -- links -> threethousandfourhundredninetyfour;
onehundredsixtysix -- links -> twothousandonehundredseventyseven;
threethousandsixhundredseventysix -- links -> twothousandseventyfour;
twothousandthreehundredninetynine -- links -> twothousandtwohundredthree;
fourthousandtwohundredeightynine -- links -> threethousandninetynine;
onehundredthirteen -- links -> onethousandsixhundredtwentysix;
threethousandeighthundredtwelve -- links -> fourthousandthreehundredeightyfive;
twothousandtwohundredfortyone -- links -> onethousandsevenhundredthirtysix;
onethousandfourhundrednineteen -- links -> fourthousandsevenhundredsixtythree;
twothousandfivehundredseventyone -- links -> sevenhundredthirty;
twothousandsevenhundredsixty -- links -> twothousandfivehundredfiftyseven;
twothousandfivehundredseventynine -- links -> thirtyfour;
fourthousandfivehundredfiftysix -- links -> threethousandfivehundredone;
thirtyseven -- links -> fourthousandsixhundredfiftyfive;
threethousandeighthundredseventysix -- links -> fourthousandninehundredforty;
fourthousandthreehundredeightythree -- links -> onethousandsixhundredthirtytwo;
onethousandfiftythree -- links -> onehundredthirtyfive;
fourthousandninehundredfour -- links -> fourthousandtwohundredtwentynine;
fourthousandeighthundredsixtyfour -- links -> onethousandtwohundredtwentynine;
onethousandninehundredsixtyfive -- links -> twohundredsix;
fourthousandninehundredtwentytwo -- links -> twothousandthreehundredninetyfive;
onethousandfourhundredeight -- links -> onethousandsixhundredthirtyseven;
eighthundredsixtysix -- links -> onethousandsevenhundredeightyseven;
onethousandtwentyone -- links -> twothousandthreehundredtwo;
thirtynine -- links -> twothousandfourhundredfour;
fourthousandonehundredseven -- links -> threethousandonehundredninetyone;
onethousandthreehundredthirtyfour -- links -> fourthousandeighthundredninetyeight;
onethousandonehundredseventynine -- links -> onethousandfourhundredfiftyeight;
onethousandthreehundredfortyone -- links -> threethousandtwohundredfiftyfour;
twothousandthreehundredninetythree -- links -> twothousandfifteen;
fourthousandthreehundredninetynine -- links -> onethousandninehundredseventysix;
onethousandsixhundredseventysix -- links -> onehundredeighteen;
threethousandthreehundredforty -- links -> fourthousandninetysix;
threethousandfivehundredeightyseven -- links -> threethousandsevenhundredsixtythree;
twothousandninehundredtwentyfour -- links -> fourthousandninehundredfiftyseven;
threethousandfourhundredfive -- links -> threethousandfourhundredfifty;
onethousandfourhundredtwentyfive -- links -> threehundredseventeen;
threethousandfourhundredtwentyone -- links -> fourthousandonehundredseventy;
threethousandsevenhundredfiftyeight -- links -> threehundredthirtynine;
sevenhundredsixtyone -- links -> twothousandeighthundredseventyeight;
ninehundredthirtyfive -- links -> twohundredfourteen;
twothousandthirtyseven -- links -> twothousandthreehundredfiftyeight;
onethousandthreehundredtwentysix -- links -> twothousandtwohundredfortyfive;
threethousandsevenhundredsixtyone -- links -> threethousandfourhundredfiftytwo;
threethousandsixhundredthirtyone -- links -> twothousandsevenhundredsixtynine;
fourhundredeightyfour -- links -> onethousandfivehundredninetyfour;
threethousandsixhundredseventythree -- links -> ninehundredtwentythree;
fourthousandsevenhundredthirtyone -- links -> sixhundredfifty;
twothousandeighthundredeightytwo -- links -> twothousandthreehundredeightyone;
twothousandtwohundredtwentyfive -- links -> fourthousandsevenhundrednine;
fourthousandsixhundredninetythree -- links -> threethousandfivehundredeightynine;
threehundredeightynine -- links -> ninetytwo;
twothousandsixhundredseventyfour -- links -> twothousandninehundredthirtyone;
onethousandsixhundredtwentyseven -- links -> twothousandthreehundredtwentyfive;
onethousandthree -- links -> fourthousandthreehundredninetyfive;
twothousandsixhundredseventytwo -- links -> fourthousandtwentynine;
twothousandfourhundredfifteen -- links -> onethousandfourhundredsixtytwo;
onehundredthirtyfour -- links -> onethousandsevenhundredfiftysix;
threethousandfivehundredninetyseven -- links -> sevenhundredtwentythree;
threethousandonehundredfortythree -- links -> threethousandonehundredfiftyone;
threethousandsevenhundredsixtysix -- links -> threethousandninehundredthirtyone;
threethousandone -- links -> onethousandsixhundredthirtyeight;
onethousandfivehundredfifty -- links -> onethousandthreehundredfiftyfour;
threethousandsevenhundredsixtyseven -- links -> sixhundredthirteen;
fourthousandonehundredthirtyseven -- links -> fourthousandsixhundredeightynine;
threethousandninehundredtwelve -- links -> threethousandonehundredtwelve;
threethousandtwohundredthirtyone -- links -> fourthousandfourhundredfortynine;
twothousandfourhundredseventyone -- links -> fourthousandninehundredsixtyeight;
fourthousandsixhundrednineteen -- links -> fourthousandninehundredninetyfour;
fourthousandonehundredfifty -- links -> threethousandfourhundredeighteen;
threethousandthreehundredsixtysix -- links -> onethousandsevenhundredseventyseven;
threethousandfivehundredfortythree -- links -> twothousandthreehundredtwentyseven;
fourthousandfiftyeight -- links -> fourthousandeighthundredtwentyfour;
threethousandtwohundredfiftysix -- links -> twothousandeighthundredseventy;
fourthousandfivehundredsixtysix -- links -> fourthousandthreehundredeightythree;
threethousandthreehundredsixtytwo -- links -> ninehundred;
fourthousandsixhundredseventy -- links -> threethousandeighthundred;