twentythousandthreehundredeighteen -- links -> thirtyfivethousandthreehundredninetysix;
twentyninethousandfourhundredninetythree -- links -> thirtythousandfourhundrednineteen;
fortytwothousandninehundredthirtyfive -- links -> twentyseventhousandtwohundredfiftyfour;
fortyfourthousandthreehundredtwelve -- links -> twentythousandninehundredninetyone;
thirtyfourthousandonehundredseven -- links -> twothousandfivehundredone;
fortyninethousandsevenhundredtwentyone -- links -> thirtyonethousandfourhundredninetyeight;
thirtyfourthousandtwohundredfortynine -- links -> fortyninethousandthreehundredtwentysix;
twentyonethousandfivehundredninetynine -- links -> twentyfourthousandsixhundredseventyfour;
nineteenthousandeighthundredsixtyone -- links -> twentythreethousandsixhundredthirtyfive;
fortysixthousandtwohundredfiftyeight -- links -> twentyeightthousandfivehundredfortysix;
twentyfivethousandeleven -- links -> fifteenthousandninehundredeighty;
thirtytwothousandthreehundredeightyfive -- links -> fortyseventhousandeighthundredfive;
thirtysixthousandfourhundredthirtyfour -- links -> fifteenthousandfourhundredeightyfour;
fortythreethousandtwentythree -- links -> nineteenthousandtwohundredfiftyfour;
eightthousandthirtyfive -- links -> thirtyninethousandeighthundredseventy;
thirtyseventhousandsevenhundredtwentytwo -- links -> eightthousandninehundredthirty;
eightthousandfivehundredseventeen -- links -> fortytwothousandfourhundredninetyfour;
fortythreethousandsixhundredninety -- links -> fortythousandonehundredeighteen;
thirteenthousandfiftyfive -- links -> twothousandonehundredeighty;
thirtysixthousandeighthundrednineteen -- links -> twentyfivethousandthreehundredtwentytwo;
thirtyfourthousandtwohundredeightyone -- links -> thirtyfourthousandthreehundredfortyseven;
fortyeightthousandonehundrednineteen -- links -> twentytwothousandsevenhundredthree;
fortyninethousandsevenhundredfiftyone -- links -> sixteenthousandninehundredeleven;
onethousandsevenhundredthirtynine -- links -> seventeenthousandninehundredeighty;
twentyfivethousandsixhundredeighteen -- links -> thirtythreethousandthreehundredthirtythree;
fortyseventhousandfivehundredeightyeight -- links -> thirteenthousandtwohundredfiftytwo;
seventhousandfourhundredtwentynine -- links -> thirtysixthousandsixhundredsixtyone;
fortysixthousandfourhundredseventyeight -- links -> fortyseventhousandfivehundredseventytwo;
twentyfourthousandsevenhundredeightyfive -- links -> thirtythousandsevenhundredeightysix;
fortysixthousandseventythree -- links -> fourteenthousandfivehundredeightyfour;
twentytwothousandfourhundredninetyfour -- links -> thirtyonethousandonehundredfortysix;
eightthousandsevenhundredfiftytwo -- links -> fourteenthousandthreehundredsixtyfive;
fortysixthousandninehundredseventyfour -- links -> thirtyninethousandfourhundredthirtytwo;
twentyeightthousandfourhundredfiftyfive -- links -> thirtysixthousandonehundredfortyfive;
fortysixthousandfivehundredtwentyseven -- links -> sixteenthousandthreehundredseventyfive;
threethousandtwohundredthirtytwo -- links -> fourteenthousandfivehundrednineteen;
fivethousandthreehundredtwentysix -- links -> fortyseventhousandninehundredthirtyseven;
sixteenthousandfivehundredtwentytwo -- links -> twentyninethousandfivehundredseventyfour;
seventhousandeighthundredten -- links -> thirtythreethousandfivehundredfiftyeight;
twentyeightthousandfivehundredthirtyfive -- links -> onethousandonehundredfive;
fortysixthousandtwohundredsixtyeight -- links -> ninethousandthreehundredfiftytwo;
eightthousandtwentyfive -- links -> onethousandfivehundredseventy;
thirtyseventhousandthirtythree -- links -> seventhousandfivehundredseventyone;
threethousandeighthundredthirtytwo -- links -> fortythousandfortyseven;
twentythousandfivehundredninetythree -- links -> fortyninethousandsixhundredten;
fortythreethousandtwohundredfifty -- links -> twentyonethousandsevenhundredfiftyeight;
twothousandthreehundredninetynine -- links -> thirtysixthousandfourhundredtwentyeight;
onethousandfourhundredseventytwo -- links -> twentyninethousandthreehundredone;
twentysixthousandsixhundredthirtyseven -- links -> eightthousandtwohundredfourteen;
thirtythreethousandfourhundredseventytwo -- links -> thirtythousandsevenhundredsixtytwo;
thirtysixthousandninehundredfiftysix -- links -> twentyeightthousandninehundredfortysix;
sixteenthousandtwenty -- links -> thirtytwothousandsevenhundredtwentynine;
twentyninethousandeighthundredfiftythree -- links -> fivehundredseventythree;
twothousandsevenhundredeleven -- links -> sixthousandfourhundredtwenty;
sixthousandtwohundredfiftyfive -- links -> sixteenthousandthreehundredfortyone;
twentyfourthousandfivehundrednineteen -- links -> fortytwothousandsixhundredsixty;
fortyeightthousandonehundredninetyseven -- links -> fortyfourthousandsixhundrednine;
nineteenthousandthreehundredsixteen -- links -> thirtysixthousandfivehundredfiftyeight;
thirtyseventhousandsixhundredthree -- links -> twentyonethousandonehundredeighty;
thirtyninethousandthreehundredsixtythree -- links -> thirtythousandninehundredtwentynine;
twentyeightthousandtwohundredfortyfive -- links -> nineteenthousandonehundredseventyseven;
twentyeightthousandtwohundredtwentythree -- links -> thirtysixthousandsevenhundred;
fourteenthousandfortyfour -- links -> sixthousandfivehundredseventy;
fortyonethousandfivehundredeightyone -- links -> fifteenthousandtwohundredseventysix;
fortyninethousandninetyfour -- links -> thirtyseventhousandninehundredninetyfive;
thirtyonethousandsevenhundredtwentytwo -- links -> twentyfivethousandtwohundredninetynine;
twentyeightthousandeighthundredtwentyfive -- links -> fortyfivethousandfourhundredthirtythree;
fifteenthousandtwentyseven -- links -> threehundredseventytwo;
thirteenthousandthreehundredforty -- links -> thirtyeightthousandfourhundredseventeen;
thirtysixthousandfourhundred -- links -> twentyonethousandfourhundredsixtyseven;
twentythousandfourhundredone -- links -> thirtyseventhousandsixhundredeightythree;
fifteenthousandninehundredninetynine -- links -> fortyeightthousandfivehundredfiftyfour;
twentyeightthousandsixhundredeleven -- links -> fortyninethousandsixty;
fortythousandsixhundredninetyseven -- links -> thirtytwothousandonehundredfortyone;
twentyonethousandninehundredninetytwo -- links -> thirtyonethousandeighthundredfortythree;
seventhousandsevenhundredfortysix -- links -> fortytwothousandsevenhundredthree;
fortytwothousandsevenhundredfiftyfive -- links -> nineteenthousandtwohundredthree;
onethousandtwohundredninetyeight -- links -> twothousandeighthundredseventy;
twentyonethousandsixhundredeightynine -- links -> thirtythreethousandeighthundredfifteen;
threethousandthree -- links -> thirtyeightthousandninehundredfiftythree;
eleventhousandsixhundredthirteen -- links -> onethousandthreehundredseventythree;
twentyonethousandonehundredfiftynine -- links -> twentyfourthousandfivehundredfourteen;
twentyseventhousandtwo -- links -> twentyseventhousandeighthundredtwentyfive;
eighteenthousandsixhundredeight -- links -> fifteenthousandninehundredthirtyfour;
thirtythreethousandonehundredeightyone -- links -> fortytwothousandeighthundredfifty;
thirtytwothousandsixhundredfiftyone -- links -> fortysixthousandfourhundredsixtyfour;
twentythreethousandthreehundredfortyone -- links -> seventeenthousandonehundredsixtynine;
twentyseventhousandtwohundredtwo -- links -> eleventhousandsevenhundredtwo;
twentysixthousandsixhundredninetysix -- links -> fortyonethousandthreehundredthirtythree;
thirtyninethousandthreehundredeightyeight -- links -> fortyeightthousandfivehundredfortyeight;
fortytwothousandfortythree -- links -> ninethousandfiftytwo;
threehundredthirtyone -- links -> twelvethousandsevenhundredninetyseven;
thirtytwothousandsevenhundredsixtyfive -- links -> fortyonethousandthreehundredtwentyfour;
eightthousandfourhundredsixtyfive -- links -> thirtysixthousandninehundredtwelve;
fivethousandonehundredfortyfour -- links -> onethousandsevenhundredfiftytwo;
sixthousandfivehundredtwelve -- links -> twentythreethousandtwentytwo;
twentythousandsevenhundredseventyfour -- links -> fortyfivethousandeighthundredseventy;
twentyeightthousandfourhundredseventyseven -- links -> twentyfivethousandeighthundredsixtyfive;
thirtythreethousandfivehundredforty -- links -> twelvethousandtwentyeight;
thirtyninethousandeight -- links -> fifteenthousandeighthundredsixteen;
fifteenthousandsixhundredthirtyseven -- links -> twentysixthousandfivehundredthirtyone;
fortythousandninehundredeightyseven -- links -> thirtyeightthousandfourhundredtwentyfour;
fortyfivethousandthreehundredninetyeight -- links -> nineteenthousandeighthundredtwelve;
sixthousandeighthundredeightyfour -- links -> thirtyfourthousandonehundredeightynine;
thirtysixthousandonehundredeightyfive -- links -> fortyonethousandeighthundredseventynine;
thirtythreethousandninehundredfiftythree -- links -> thirtytwothousandsevenhundredseventyfour;
fourthousandninehundredsixty -- links -> twentyonethousandeighthundredeightythree;
ninethousandtwohundredfifteen -- links -> fourthousandthreehundredsixtysix;
thirtyfivethousandeighthundredeighty -- links -> sixthousandfourhundredforty;
fourteenthousandthreehundredfiftyone -- links -> fivethousandsevenhundredtwentysix;
twentythousandonehundredfortyfour -- links -> thirtysixthousandfivehundredeleven;
twentyonethousandsevenhundredtwentysix -- links -> thirtyonethousandsixhundredseventynine;
fortyeightthousandfivehundredthirtytwo -- links -> twentyseventhousandfortythree;
thirtyninethousandfourhundredseventyone -- links -> fortysixthousandsixhundredtwentytwo;
fourthousandfivehundredthirtyeight -- links -> twentyfourthousandsixhundredtwentyfive;
threethousandtwohundredthirtynine -- links -> sixthousandonehundredfive;
fortyfivethousandsixtyfour -- links -> fortythousandonehundredeightysix;
thirtysixthousandsevenhundredseventytwo -- links -> twentyninethousandtwohundredthirtyseven;
twelvethousandsixhundredeightyeight -- links -> fortyonethousandeighthundredseventythree;
twentythousandfourhundredtwentyseven -- links -> twentysixthousandninehundredfourteen;
fourteenthousandninehundredsix -- links -> twentyninethousandsixhundred;
ninethousandeightyfive -- links -> fortyseventhousandsixhundredfiftyfour;
thirtytwothousandfivehundredforty -- links -> twentythreethousandfivehundrednine;
twentyfivethousandsixhundredfive -- links -> twentyfivethousandthreehundredtwo;
tenthousandtwentyfour -- links -> twentyeightthousandonehundredfiftyfour;
onethousandeighthundredseventytwo -- links -> ninethousandthreehundredsixtyfour;
twelvethousandfourhundredninetyeight -- links -> twentyeightthousandeightytwo;
thirtyeightthousandtwohundredeighteen -- links -> thirtyonethousandfivehundredthirtyseven;
thirtyeightthousandeighthundredninetythree -- links -> twentyonethousandtwohundredfortyseven;
threethousandfivehundredfive -- links -> thirtyninethousandfourhundredeleven;
twentythousandsevenhundredeightyfive -- links -> fortyonethousandsixhundredsixtyfive;
twentyeightthousandtwohundred -- links -> twothousandthreehundredeightysix;
ninety -- links -> twelvethousandsevenhundredfortyfive;
seventhousandthreehundredfiftyfour -- links -> twentythousandninehundredfiftyseven;
twentyeightthousandsixhundredtwentyfour -- links -> twentyonethousandthreehundredfiftyfive;
sixthousandonehundredfiftythree -- links -> seventeenthousandtwohundredtwentysix;
twentyninethousandthreehundredseventyfive -- links -> thirtyonethousandsevenhundredfortysix;
fifteenthousandten -- links -> thirteenthousandonehundredthirty;
threethousandtwohundredthree -- links -> onethousandfivehundredone;
fivethousandfourhundredfiftyfive -- links -> eightthousandninehundredtwentytwo;
fourteenthousandfourhundredseventeen -- links -> fourteenthousandonehundredthirtyfive;
thirtyninethousandfourhundredfortynine -- links -> thirteenthousandfourhundredsixtytwo;
sixthousandeighthundredfour -- links -> fortyninethousandninetythree;
twentyonethousandsevenhundredfiftyone -- links -> sixhundredsixteen;
sixteenthousandsevenhundredfiftyfive -- links -> fortyeightthousandtwohundredsixtyfour;
twelvethousandsixhundredninetyfive -- links -> twentyninethousandtwohundredfortysix;
twentyseventhousandfivehundredsixteen -- links -> fortyfourthousandeighthundredsixtysix;
thirtytwothousandonehundredtwenty -- links -> sixthousandeighthundredninety;
thirtyninethousandthreehundredseventyfive -- links -> fortyninethousandthreehundredeightyone;
ninethousandthreehundredninetyfour -- links -> seventhousandonehundredeightysix;
thirtytwothousandsixhundredthirtythree -- links -> onethousandfourhundredseventynine;
twentyeightthousandeighthundredninetyeight -- links -> thirtythousandtwohundredsixtyfour;
twentysixthousandtwohundredfiftytwo -- links -> eleventhousandeighthundredninety;
sixthousandfivehundredsixtysix -- links -> twentythousandsevenhundredeight;
fourhundredseven -- links -> fortyfourthousandfivehundredfiftyone;
threethousandfortytwo -- links -> twentyonethousandonehundredeighteen;
twelvethousandninehundredthirtyfive -- links -> thirtyonethousandeighthundredeleven;
twentyfourthousandninehundredeight -- links -> fourthousandsevenhundredninetytwo;
thirtytwothousandfivehundredeightysix -- links -> fourteenthousandsevenhundredseventyeight;
fivethousandninehundredseventyeight -- links -> fifteenthousandsixhundredseven;
thirtythreethousandeighthundredfiftyone -- links -> thirtyeightthousandfortyeight;
eighteenthousandsevenhundredten -- links -> fortythousandeighthundredeightytwo;
twentyonethousandfivehundredninetynine -- links -> fivethousandthreehundredeightythree;
nineteenthousandfourhundredeighteen -- links -> tenthousandninehundredseventyeight;
thirtytwothousandfivehundredfiftyfive -- links -> thirtyonethousandonehundredthirtyeight;
tenthousandtwohundredseventy -- links -> onehundredthirtyeight;
onethousandeighthundredtwentyfour -- links -> thirtyeightthousandseven;
thirtyfourthousandtwohundredeightyfour -- links -> thirtythousandonehundredseventyseven;
twentysixthousandtwohundredsixty -- links -> thirtyninethousandtwohundredeightythree;
sixteenthousandeighthundredninetytwo -- links -> fortyfourthousandsevenhundredfourteen;
thirteenthousandninehundredninetyeight -- links -> fortytwothousandtwohundredeighty;
thirtyfivethousandthreehundredfortyfive -- links -> twelvethousandeighthundredthirtyseven;
sixthousandonehundredfortytwo -- links -> twentysixthousandfourhundredfifty;
fortyseventhousandninehundredthree -- links -> thirtythousandninehundredfortytwo;
twentyfourthousandninehundredeightythree -- links -> twentytwothousandonehundredeightythree;
twentytwothousandonehundredthree -- links -> eighteenthousandninehundredseventyeight;
twothousandthreehundredninetythree -- links -> ninethousandtwohundredtwentyeight;
fortyseventhousandtwohundredfortyeight -- links -> fortyfourthousandeighthundredeighteen;
fortyonethousandfourhundredeightyseven -- links -> fourteenthousandninehundredeighty;
eighteenthousandtwohundredfortyfour -- links -> onethousandthreehundredthirteen;
twentytwothousandfivehundredthirty -- links -> fortythousandsixhundredninetyone;
thirtyonethousandfourhundredninetytwo -- links -> fortyninethousandtwohundredeight;
twentyninethousandeighthundredsixtyfour -- links -> twentyonethousandonehundredeightyfive;
fifteenthousandsixhundredfortyone -- links -> twothousandthreehundredfortyfour;
twentyfivethousandsevenhundredeightynine -- links -> thirtyeightthousandninehundredeightyseven;
sixhundredsixtyfour -- links -> eightthousandfourhundredninetyfive;
thirtythousandsixhundredthirtysix -- links -> twothousandfourhundredthree;
thirtythreethousandfivehundredthirtyseven -- links -> thirteenthousandfourhundredninetyone;
thirtyfivethousandsevenhundredsix -- links -> twentythousandeighthundredseventyone;
tenthousandsevenhundredseventythree -- links -> twentyninethousandfourhundredsixtyeight;
twentyninethousandtwohundredthirtyone -- links -> fortyfourthousandsixtythree;
eleventhousandonehundredsixtynine -- links -> thirtythousandsevenhundredthree;
twentyseventhousandfourhundredfortytwo -- links -> fortytwothousandsixhundredseventytwo;
fortysixthousandthreehundredsixtythree -- links -> twelvethousandeighthundredtwenty;
onethousandsevenhundredfiftynine -- links -> twentyfourthousandsixhundredfiftyfour;
twentyfourthousandonehundredthirtyfive -- links -> fortytwothousandthreehundredthirteen;
fortyseventhousandfourhundred -- links -> threethousandtwohundredthirty;
twentyfivethousandtwohundredthirtynine -- links -> thirtythreethousandfourhundredfiftyfive;
fortyninethousandsevenhundredfifty -- links -> twentyninethousandeighthundredninetyseven;
fortyseventhousandfiftythree -- links -> tenthousandeighthundredeightytwo;
thirtyeightthousandtwohundredfifty -- links -> twentyeightthousandonehundredeight;
thirtyfourthousandninehundredten -- links -> fortyseventhousandfourhundredfifteen;
twentyfourthousandthreehundredtwentyfour -- links -> thirteenthousandfivehundredsixtyfour;
fortytwothousandfivehundredeightytwo -- links -> fivethousandtwohundredtwentynine;
nineteenthousandthreehundredseventyfour -- links -> fourthousandtwentythree;
eighteenthousandeighthundredsixtyfive -- links -> fivethousandsixhundredthirtyeight;
thirtyonethousandfivehundredseventyfive -- links -> sixthousandsevenhundredfortytwo;
seventhousandninehundredsixtyfive -- links -> twentyfivethousandthreehundredfiftynine;
fortyeightthousandfiftysix -- links -> thirteenthousandtwentythree;
twentyninethousandsixhundredtwentysix -- links -> twentyfourthousandsevenhundredseventynine;
onethousandfivehundredeight -- links -> nineteenthousandfifteen;
fortysixthousandthreehundredsixtytwo -- links -> fortyfourthousandninehundredninety;
thirtytwothousandonehundredtwelve -- links -> fivethousandthreehundredfortynine;
twentyonethousandonehundredfortyseven -- links -> eleventhousandthirteen;
onehundredforty -- links -> fifteenthousandeighthundredfortyone;
thirtythousandninehundredfortytwo -- links -> fourteenthousandfourhundredfiftyone;
twentysixthousandsevenhundredsixtysix -- links -> fortyfourthousandfourhundredfortythree;
seventeenthousandthreehundredfortyseven -- links -> twentyseventhousandsevenhundredfortynine;
twentytwothousandfivehundredsix -- links -> twentyninethousandthreehundredfour;
twentytwothousandfourhundredthree -- links -> thirtyseventhousandonehundredninetyone;
fortythousandninetysix -- links -> twentyninethousandonehundredseventyfour;
twentyninethousandthreehundredsix -- links -> thirtyfivethousandonehundredeightyfour;
fortyonethousandonehundredthirtyeight -- links -> threethousandfourhundredeightynine;
fortyonethousandonehundredninetynine -- links -> eightyeight;
fortytwothousandfivehundredseventyfive -- links -> eighteenthousandonehundredfortythree;
ninethousandsevenhundredfortyfive -- links -> fivehundredseven;
fortyonethousandsevenhundredseventyseven -- links -> fortyfivethousandthreehundredtwo;
tenthousandthreehundredeightythree -- links -> eleventhousandonehundredfortyone;
nineteenthousandsixhundredthirtytwo -- links -> fortysixthousandthreehundredsixtyfive;
fourthousandthreehundredforty -- links -> tenthousandsixhundredthirtysix;
seventeenthousandthreehundredfortyfive -- links -> sevenhundredfiftyone;
fortythreethousandfivehundredeighteen -- links -> fortythousandninehundredninety;
twentysixthousandsixhundredtwentytwo -- links -> twelvethousandonehundredseventytwo;
sixthousandeighthundredeightynine -- links -> fortysixthousandfifteen;
twentyonethousandthreehundredfifteen -- links -> thirtyonethousandthreehundredthirtyseven;
fortyseventhousandonehundredsixtyfive -- links -> twentythousandsixhundredtwentyeight;
thirtytwothousandfifty -- links -> twentyonethousandninetysix;
nineteenthousandtwohundredseventeen -- links -> twohundredthirtyeight;
onethousandsixty -- links -> eightthousandonehundredninetyfive;
seventhousandonehundredseventyeight -- links -> fortyfivethousandthreehundredfortytwo;
fortythousandsevenhundredninetyseven -- links -> thirtyfourthousandsevenhundredfiftyfour;
twentythreethousandtwohundredfiftytwo -- links -> eighteenthousandfourhundredseven;
fortyeightthousandsixhundredthree -- links -> ninethousandninehundred;
twelvethousandninehundredeightyseven -- links -> fourteenthousandeighthundredfifty;
fivethousandfourhundredsixtysix -- links -> fifteenthousandsevenhundredfiftyfour;
thirtythreethousandeighthundredthirty -- links -> fortyfourthousandsixhundredfifty;
twentytwothousandsevenhundredfiftyeight -- links -> twentythreethousandsevenhundredfifty;
thirteenthousandtwentyfive -- links -> thirtysixthousandonehundredsixtyseven;
eightthousandninetyfive -- links -> nineteenthousandonehundredthirtyeight;
twentyeightthousandninehundredeightytwo -- links -> thirtyonethousandthreehundredsixtyeight;
twentysixthousandthreehundredeightysix -- links -> twentyseventhousandfourhundredninetyfour;
eightthousandninehundredfiftytwo -- links -> thirtyonethousandthreehundredfive;
twentyonethousandsevenhundredseventy -- links -> twentysixthousandfivehundredthirteen;
eleventhousandfourhundredfiftyone -- links -> fortyfivethousandfivehundredfiftyseven;
thirtythousandfourhundredsixtysix -- links -> fortythreethousandsevenhundredsixty;
twentyfourthousandtwohundredtwentyseven -- links -> twentythousandninehundredfortyeight;
eighteenthousandfivehundredseventeen -- links -> thirtythreethousandsixhundredtwentynine;
tenthousandonehundredthree -- links -> twentythreethousandfivehundredfortyone;
twentyfourthousandtwohundredninetytwo -- links -> thirtyfourthousandtwohundredtwentythree;
thirtyfivethousandfourhundredfortyone -- links -> fortythreethousandninehundredfortyfour;
fortysixthousandthreehundredeight -- links -> thirtyseventhousandfivehundredninetynine;
thirtyeightthousandthreehundredninety -- links -> fortyeightthousandsixhundredtwentysix;
thirtyfivethousandnine -- links -> thirtytwothousandfivehundredseventy;
twentyseventhousandsixhundredthirteen -- links -> twentyonethousandsixhundredninetynine;
twentyninethousandninehundredeightyseven -- links -> twentyninethousandtwohundredninetyeight;
twentyfourthousandninehundredeightynine -- links -> fortyeightthousandfivehundredsixtyfour;
fortytwothousandeighthundredtwentyeight -- links -> fortyeightthousandonehundredfortyfour;
fortyninethousandfourhundredthirtyone -- links -> twentyfourthousandfivehundredtwentyone;
thirtythreethousandfourhundredsixtysix -- links -> thirtyseventhousandsixty;
twentyonethousandsixhundredsixtyone -- links -> twentytwothousandsixhundredfortyseven;
fortyeightthousandfivehundredtwentyseven -- links -> fourteenthousandthreehundredone;
fortythreethousandthreehundrednine -- links -> eighteenthousandsixhundredtwentythree;
thirtyfourthousandfivehundredseven -- links -> eightthousandfourhundredfour;
twentythreethousandsixhundredsixtythree -- links -> twentytwothousandfivehundredsixtyeight;
thirtyseventhousandninehundredfiftyfive -- links -> twentythreethousandthreehundredseventyeight;
thirtyeightthousandtwohundredfortyseven -- links -> ninethousandfivehundredseventynine;
threethousandsevenhundredninetytwo -- links -> seventhousandfivehundredtwentyone;
twentyonethousandthirty -- links -> fortythreethousandfourhundred;
twelvethousandonehundredfifty -- links -> twentyfivethousandeighthundredfiftysix;
tenthousandfivehundredeighty -- links -> twentyeightthousandthreehundredtwentysix;
eighteenthousandonehundredfortythree -- links -> thirtyninethousandfourhundredfiftyseven;
twelvethousandsixhundredtwentysix -- links -> nineteenthousandthreehundredninetynine;
twentytwothousandfivehundredsixteen -- links -> twentyseventhousandtwohundredninetytwo;
fortyeightthousandsevenhundredfiftyone -- links -> fortytwothousandnine;
fortyseventhousandfivehundredfiftynine -- links -> fortytwothousandninehundredthirtyfour;
tenthousandninehundredeightyfive -- links -> thirtyfivethousandninehundredfortyfive;
fortysixthousandsixhundredfiftysix -- links -> fortythreethousandfive;
fortytwothousandtwohundredtwentytwo -- links -> twentyeightthousandeighthundredfiftyone;
fortyfivethousandonehundredthirtyeight -- links -> thirteenthousandninehundredthirty;
thirtyninethousandninehundredthirtyfour -- links -> thirtyeightthousandtwohundredtwelve;
seventhousandsevenhundredeightyfive -- links -> twentyninethousandsevenhundredtwentyone;
eighteenthousandsixhundredtwentytwo -- links -> seventeenthousandsixhundredsixtyfour;
twentyninethousandsixhundredsixtyseven -- links -> thirtythousandtwohundredsixty;
twentyfourthousandsixhundredfour -- links -> fivethousandfivehundredeightythree;
fortyninethousandthreehundredsixtyeight -- links -> sixthousandsixhundrednineteen;
fortyonethousandsixhundredten -- links -> threethousandonehundredtwentythree;
fortyseventhousandtwohundredthirtynine -- links -> sixthousandsevenhundredfour;
twentyfivethousandfortynine -- links -> twentyseventhousandfourhundredthirteen;
fourteenthousandthreehundredeighteen -- links -> fortysixthousandsixhundredtwentythree;
twentyfourthousandonehundredeighty -- links -> fortyninethousandsixhundredninetythree;
thirtyninethousandsevenhundredsixtyfive -- links -> sixthousandtwohundrednineteen;
twentyseventhousandthreehundredeightyone -- links -> seventhousandsevenhundredeleven;
sixthousandthreehundredtwelve -- links -> fortytwothousandfiftytwo;
fivethousandeighthundredsixtyfour -- links -> twelvethousandfourhundredfifty;
thirtythousandsixhundredtwentyfour -- links -> fortyninethousandseventysix;
thirtythreethousandsixhundredfiftyeight -- links -> thirteenthousandonehundredeightyone;
twentyfivethousandfourhundredthirtysix -- links -> fortyseventhousandfourhundredfortyeight;
fourteenthousandsixtyone -- links -> twentythreethousandeighthundrednineteen;
thirtyseventhousandtwentyfive -- links -> sixteenthousandninetytwo;
twentytwothousandthreehundredsixtythree -- links -> fortythreethousandonehundredseventeen;
ninethousandfivehundredseventynine -- links -> twothousandonehundredninetyone;
fortythreethousandfourhundredninetytwo -- links -> fortytwothousandfourhundredfourteen;
eighteenthousandsixhundredtwentythree -- links -> thirtythreethousandsixhundredseventy;
thirtythousandonehundredsixtyseven -- links -> eightthousandthreehundredseventy;
seventeenthousandeighthundredseventyone -- links -> fortyninethousandsevenhundredforty;
twothousandthreehundredtwentynine -- links -> twentyninethousandeighthundredninetyfive;
tenthousandeighthundredeight -- links -> fourteenthousandninehundredthree;
threethousandfivehundredeight -- links -> sixhundredthirtyeight;
thirtyfourthousandonehundredtwentyfour -- links -> thirtyseventhousandtwohundredthirtyeight;
fortythreethousandeighthundredfiftyfive -- links -> fortythreethousandeighthundredeleven;
eighteenthousandeightyseven -- links -> thirtythreethousandsixhundredfiftyfour;
thirtyfivethousandfourhundredfourteen -- links -> twentyfourthousandfivehundredfiftyone;
thirtyseventhousandfivehundredfiftytwo -- links -> thirtythousandfiftytwo;
thirtyfourthousandtwentytwo -- links -> onethousandonehundrednineteen;
twelvethousandninehundredfortytwo -- links -> fortythreethousandthreehundrednine;
threethousandtwohundredeightyseven -- links -> fifteenthousandsevenhundredninetyseven;
fortyonethousandthreehundred -- links -> fortysixthousandtwohundredseventythree;
twothousandtwohundredfortysix -- links -> ninehundredeight;
fivethousandeighthundredninetynine -- links -> fortyfourthousandfivehundredninetyeight;
eightthousandfourhundredseventyeight -- links -> thirtyninethousandfourhundredten;
twentyfourthousandeighthundredseventyfour -- links -> eighteenthousandfourhundredtwentyfour;
thirtyfivethousandsevenhundredfifteen -- links -> seventhousandtwohundredfortysix;
ninethousandtwohundredsixtyeight -- links -> fortytwothousandonehundredten;
twentyfivethousandeighteen -- links -> threethousandfivehundredtwelve;
seventhousandeightyseven -- links -> fortythousandseventytwo;
eightthousandsixhundredninetysix -- links -> twentythreethousandtwohundredseventytwo;
tenthousandfivehundredeightyeight -- links -> thirteenthousandfourhundredfortyfour;
seventhousandfourhundredseventyeight -- links -> fortyninethousandfourhundredninetyfour;
twentythousandthreehundredtwentyeight -- links -> fortyfivethousandfourhundredtwentyfour;
twentyfourthousandonehundredseventyfour -- links -> seventhousandsevenhundredtwentynine;
fourteenthousandthreehundredfifty -- links -> thirtytwothousandthreehundredsixtytwo;
fortyseventhousandsevenhundredeightyone -- links -> fortyonethousandsixhundredfiftynine;
fortyfivethousandsevenhundredfifty -- links -> fortythreethousandeighthundredtwentyeight;
fortyeightthousandninehundredsixtyfour -- links -> sixthousandthreehundredfive;
fortysixthousandfivehundredfiftyeight -- links -> thirtythreethousandsixhundredninetynine;
twentyninethousandthreehundredeighty -- links -> seventeenthousandsevenhundredfiftythree;
fourteenthousandeighthundredeightyfour -- links -> thirtyseventhousandthreehundredeighteen;
ninethousandtwohundredfiftythree -- links -> thirteenthousandsixhundredtwenty;
twelvethousandthreehundredfortynine -- links -> sixteenthousandeighthundredthirtyfive;
sixthousandthreehundredfortyeight -- links -> twentysixthousandfourhundredeightythree;
fivethousandtwohundredfive -- links -> twentysixthousandfourhundredsixtyone;
fortyninethousandthreehundredeightythree -- links -> eleventhousandonehundredseventythree;
thirtyfourthousandfiftyone -- links -> fortythreethousandninehundredthirtyeight;
thirtytwothousandfourhundredfortysix -- links -> sixthousandeighthundredseventyeight;
twentyseventhousandfivehundredninetytwo -- links -> seventeenthousandthreehundredfortyfive;
twentythreethousandtwohundredforty -- links -> twenty;
eightthousandonehundredfortyeight -- links -> seventeenthousandeighthundredthirtytwo;
thirtythreethousandsixhundredseventyone -- links -> thirtyonethousandfortythree;
fortyeightthousandfivehundredthirtyfour -- links -> thirtythousandsevenhundredeighty;
fortytwothousandthreehundredfiftythree -- links -> eighteenthousandthreehundredsixtyeight;
thirtyfivethousandninehundredfifty -- links -> thirtyseventhousandninehundredeightysix;
threethousandtwohundredninetytwo -- links -> sixteenthousandfiftynine;
twentyonethousandthreehundredtwentyeight -- links -> fivehundredsix;
sixthousandfivehundredone -- links -> sixteenthousandsixhundredfiftythree;
seventeenthousandseventynine -- links -> thirtyfivethousandfourhundredthirtyfive;
twentythousandfivehundredfiftysix -- links -> twentyeightthousandfivehundredsixtyone;
seventeenthousandsevenhundredthirtyone -- links -> twentyeightthousandtwohundredeightyone;
twentythousandtwohundredeightyeight -- links -> fortyninethousandtwohundredninetyfive;
fivethousandfivehundredfiftytwo -- links -> fourteenthousandsevenhundredfiftyfive;
twothousandthreehundredseventyone -- links -> fortyninethousandtwohundredsixtyseven;
thirtythousandtwentyone -- links -> thirtyfourthousandfourhundredeightynine;
twothousandthreehundredninetythree -- links -> fourteenthousandsevenhundredsixtyfive;
tenthousandninehundredtwo -- links -> thirtyonethousandonehundredfifteen;
fortyseventhousandfortythree -- links -> fortytwothousandfortynine;
fivethousandonehundredfortytwo -- links -> onethousandonehundredfortynine;
fortyninethousandfourhundredseventyfour -- links -> twelvethousandsixhundredfiftyfour;
thirtyonethousandsevenhundredfiftyseven -- links -> thirtythreethousandthreehundrednineteen;
fourteenthousandninehundredfiftyfour -- links -> thirteenthousandeighthundredtwenty;
onethousandseventyfour -- links -> ninethousandthreehundredfiftytwo;
seventeenthousandsevenhundredseventeen -- links -> fourthousandfivehundredninety;
fortythousandthreehundredseventythree -- links -> fortyninethousandeightytwo;
nineteenthousandthreehundredseventysix -- links -> thirtyfourthousandfivehundredninetynine;
thirtyseventhousandsevenhundredeightyeight -- links -> fifteenthousandonehundredeightyfour;
twentyonethousandsevenhundredeighteen -- links -> fourthousandninehundredsix;
thirtyfivethousandeighthundredsixtythree -- links -> seventhousandfivehundred;
ninethousandthirtyone -- links -> fortyninethousandthirtythree;
fortyeightthousandtwo -- links -> twentythousandsixhundredseventy;
thirtythousandninehundredone -- links -> eightthousandfourhundredfortyseven;
twentytwothousandsevenhundredseventyfive -- links -> fortyninethousandonehundredseventyfive;
twentyfourthousandthreehundredfifteen -- links -> fortysixthousandthreehundredseventyseven;
eightthousandtwohundredfive -- links -> twentyeightthousandfortyfour;
twentytwothousandfourhundredfiftyeight -- links -> twentyonethousandtwohundredseventyeight;
fortyseventhousandtwohundredninetyseven -- links -> threethousandfortyfive;
fourteenthousandthreehundredsix -- links -> twentythreethousandsixhundredfortyeight;
fortytwothousandfourhundredsixtythree -- links -> twentyninethousandfivehundredtwentyfive;
twentythreethousandeightyone -- links -> fourthousandeighthundredtwentyseven;
twentyeightthousandfivehundredeightynine -- links -> tenthousandtwohundredtwelve;
twentythreethousandsixhundredfiftynine -- links -> onethousandeighthundredtwo;
thirtythousandfivehundredninetysix -- links -> sixthousandfivehundredeightythree;
thirteenthousandninehundredeightytwo -- links -> fortyninethousandthreehundredsixtynine;
fourthousandthreehundred -- links -> seventhousandeighthundrednine;
thirtythousand -- links -> twohundredseventysix;
twentyonethousandeighthundredfiftynine -- links -> fifteenthousandfortythree;
eightthousandninehundredeleven -- links -> fourthousandfifteen;
ninethousandonehundredsixtytwo -- links -> threethousandseventytwo;
fifteenthousandfivehundrednine -- links -> fourteenthousandsixhundredseventyone;
fourteenthousandninetythree -- links -> thirtysixthousandsixhundredeightythree;
ninethousandninehundredthree -- links -> fortyninethousandtwohundredeightyfive;
thirtyfivethousandonehundredninetysix -- links -> fortyninethousandfortyone;
fortyonethousandthreehundredsixtyeight -- links -> thirtyeightthousandeighthundredseventyfive;
twentyfivethousandninehundredfortysix -- links -> thirtyfivethousandfivehundredseven;
thirtyfourthousandeightysix -- links -> twentythreethousandtwohundredfiftyfive;
twentyfourthousandninehundredninetythree -- links -> twentyeightthousandfivehundredeightyeight;
fourthousandthirtythree -- links -> twentyseventhousandfivehundredninetyseven;
twentyfourthousandsixhundredseventytwo -- links -> seventhousandfivehundredtwentyone;
fortyfivethousandeighthundredthirtyfive -- links -> twentysixthousandsixhundredfiftysix;
fortyninethousandfivehundredeightyseven -- links -> thirtyfivethousandfourhundredthirty;
seventeenthousandsevenhundredtwentynine -- links -> sixteenthousandsevenhundredfortyfive;
thirtythousandfourhundredfortyfive -- links -> thirtythreethousandsixhundredseventyseven;
twentyfourthousandsixhundredfour -- links -> twentyseventhousandfourhundredfiftysix;
twentyeightthousandfourhundredfiftythree -- links -> thirtysixthousandtwohundredone;
fortysixthousandninehundredninetysix -- links -> fortyeightthousandsevenhundredtwentyseven;
thirtyseventhousandsixhundredtwentysix -- links -> thirtyfourthousandeighthundredone;
thirtythousandfivehundredninetyfour -- links -> seventeenthousandtwohundredthirtynine;
fortyfivethousandfourhundredtwentyseven -- links -> seventhousandonehundredfour;
fortythousandfourhundredsixtyfive -- links -> thirteenthousandfourhundredseventythree;
fivethousandeighthundredninetysix -- links -> thirtyfivethousandthreehundredsixtynine;
twentyninethousandtwohundredsixtyfour -- links -> fortyseventhousandonehundredseventyfour;
fortyeightthousandsixhundredfifteen -- links -> eighthundredtwentythree;
seventeenthousandfourhundredninetyfour -- links -> twentytwothousandfourhundredfiftyone;
seventhousandfourhundredfortyfour -- links -> thirtyeightthousandtwohundredfortytwo;
sixthousandfourhundredthirtyfive -- links -> eightthousandthreehundredeight;
sixteenthousandsixhundredseventytwo -- links -> twelvethousandonehundredfortythree;
seventeenthousandonehundredthirtyfour -- links -> tenthousandtwentysix;
fortyonethousandfourhundredtwentyeight -- links -> eightthousandthreehundredeightythree;
fortysixthousandsevenhundredtwenty -- links -> thirteenthousandfourhundredfortyseven;
twentyfourthousandsevenhundredseventyeight -- links -> fivethousandninehundredfiftynine;
twentythousandeighthundredfortyfour -- links -> fourteenthousandtwentyone;
fortyseventhousandeighthundredninetysix -- links -> fortyeightthousandeighthundredfortyseven;
thirtythousandtwentysix -- links -> eleventhousandonehundredseventyfour;
seventhousandthreehundredseventy -- links -> twentythousandonehundredfortyeight;
fortytwothousandninetyfive -- links -> eleventhousandthreehundredninetynine;
fortyseventhousandeighthundredfiftytwo -- links -> thirtythousandonehundredeightyfour;
tenthousandsixhundredsixtyseven -- links -> twentyfivethousandsixhundredfourteen;
twentyninethousandonehundredtwentyone -- links -> onethousandfourhundredone;
thirtyonethousandthreehundredseventyfour -- links -> fortythousandfourhundredtwo;
twelvethousandeightytwo -- links -> seventhousandsevenhundredseventyfive;
twentysixthousandtwohundredsixtythree -- links -> thirtysixthousandfourhundrednine;
thirtyeightthousandsevenhundredfortytwo -- links -> fortyfivethousandeighthundredtwentythree;
threethousandfourhundredninetynine -- links -> thirtyonethousandthirtysix;
fortyseventhousandthreehundredseventy -- links -> nineteenthousandfourhundredeightyfive;
sixthousandeighthundredsixtythree -- links -> twentyfourthousandsevenhundredtwentyseven;
fortyseventhousandsevenhundredten -- links -> eighteenthousandsevenhundredsixtysix;
twentyeightthousandonehundredfourteen -- links -> twothousandsevenhundredfortynine;
twothousandthreehundredsixteen -- links -> twohundredeightythree;
twothousandseventythree -- links -> sixthousandeighthundredeightynine;
seventeenthousandfortysix -- links -> nineteenthousandfivehundredthirtyseven;
fivehundredfour -- links -> twentytwothousandeighthundredfortyseven;
thirtythreethousandonehundredsixtytwo -- links -> twentyonethousandfourteen;
eightthousandfourhundredfiftyeight -- links -> eightthousandfourhundredninetysix;
twentyonethousandthreehundredsixteen -- links -> thirtythousandeighthundredsix;
twentythousandfivehundredfortytwo -- links -> fortyonethousandeighthundredtwenty;
twentysixthousandninehundredninetytwo -- links -> thirtytwothousandonehundredfiftyfive;
thirtytwothousandthreehundredeightytwo -- links -> twentythousandthreehundredsix;
twentyonethousandfourhundrednineteen -- links -> thirtyeightthousandeighthundredtwentyseven;
thirtytwothousandfivehundredtwentyfour -- links -> tenthousandnineteen;
thirtythreethousandfivehundredten -- links -> eleventhousandfivehundredfifteen;
thirtytwothousandfivehundredeightyeight -- links -> twothousandonehundredeightyone;
thirtyeightthousandeighthundredthirtyseven -- links -> sixthousandsixhundredtwentysix;
thirtysixthousandonehundredsixtyeight -- links -> thirtytwothousandsevenhundredtwentythree;
ninethousandsevenhundredseventy -- links -> thirtythreethousandeighthundredninetysix;
seventhousandninehundredtwentyfour -- links -> thirtyeightthousandsixtysix;
eighteenthousandfivehundredfour -- links -> fortyfourthousandninetythree;
fifteenthousandtwohundredfortyseven -- links -> fifteenthousandthreehundredfortytwo;
twentythousandninehundredfiftyone -- links -> eighteenthousandsevenhundredseventyfour;
twentythousandsevenhundredtwentytwo -- links -> fortysixthousandeighthundredsixtysix;
fortytwothousandtwenty -- links -> twentyfourthousandtwohundrednine;
thirtysixthousandfivehundredsixtyeight -- links -> thirtythousandtwohundredfortyseven;
fortyonethousandsevenhundredninetyfour -- links -> fortyonethousandtwo;
thirtyninethousandonehundredthirty -- links -> twentytwothousandtwohundredninetytwo;
fourteenthousandninehundredseventyseven -- links -> twentysixthousandthirtynine;
twentysixthousandonehundredtwo -- links -> thirtyninethousandsevenhundredsixteen;
fortythreethousandeighthundredninetyseven -- links -> fourteen;
fortytwothousandtwohundredeightythree -- links -> twentyninethousandfivehundredeightynine;
twentyeightthousandninehundredthirtyone -- links -> twentyonethousandsixhundredthirtyeight;
thirtyeightthousandfiftytwo -- links -> fortythousandthreehundred;
twentyonethousandthreehundred -- links -> eightthousandtwohundredeighteen;
eleventhousandonehundredeighteen -- links -> thirtyseventhousandsevenhundredninetyseven;
threethousandninehundredeleven -- links -> eighthundredseventyfour;
ninethousandfourhundred -- links -> seventeenthousandonehundredfortyfour;
twentyeightthousandfourhundredtwentytwo -- links -> thirtyonethousandfivehundredthirtytwo;
thirtyfivethousandthirty -- links -> thirtyninethousandthreehundredeightyfour;
nineteenthousandtwohundredsixtynine -- links -> thirtythreethousandsixhundredsixteen;
thirtyonethousandeighthundredninety -- links -> fourthousandonehundredsixtysix;
thirtyseventhousandninehundredseventynine -- links -> eighteenthousandfortynine;
seventhousandsixhundredsixteen -- links -> twentyeightthousandsevenhundredeightysix;
thirtyseventhousandeighthundredfive -- links -> twentyonethousandeighthundredthirty;
threethousandeighthundredeightyfour -- links -> twentyninethousandfiftyseven;
eighteenthousandfivehundredfiftythree -- links -> fortythreethousandseventeen;
eighteenthousandeighthundredeighteen -- links -> fifteenthousandfivehundredsixtytwo;
thirtytwothousandeighthundredtwelve -- links -> twentythreethousandninehundredthirtyfive;
seventhousandsixhundredfortyone -- links -> eleventhousandfifty;
fortysixthousandonehundredtwentynine -- links -> fivehundredfifty;
fortytwothousandfivehundredfortyone -- links -> twentyonethousandonehundredeleven;
ninethousandsixhundredseventy -- links -> thirtythreethousandsevenhundredseventythree;
fortytwothousandsevenhundredeleven -- links -> twentythreethousandeighthundredfiftyeight;
sixteenthousandsixhundredfour -- links -> twentyfourthousandeighthundredtwentyeight;
thirtyseventhousandonehundredfifteen -- links -> fivehundredsixtyfive;
fortysixthousandsixhundredthree -- links -> thirtysixthousandninehundredseventeen;
twentyfivethousandonehundrednineteen -- links -> thirtyfourthousandsevenhundredthirtytwo;
twentyninethousandfivehundredeightythree -- links -> twentyseventhousandonehundredeightysix;
seventhousandeleven -- links -> tenthousandfourhundredeightyone;
thirtysixthousandfour -- links -> thirtytwothousandtwohundredtwentytwo;
thirtysixthousandonehundredthirteen -- links -> twentyeightthousandfifteen;
fortythousandsixhundredseventeen -- links -> twentyonethousandeighthundredeightyeight;
eleventhousandthreehundredthirtyone -- links -> eighthundredforty;
eightthousandfivehundredeighty -- links -> sixteenthousandfourhundredninetyseven;
twentythousandsixhundredthirtyfive -- links -> twentythousandeighthundredeighteen;
twentyseventhousandninehundredsix -- links -> twentyfivethousandninehundredsixtyseven;
fortyeightthousandeighthundredeighteen -- links -> twelvethousandninehundredeight;
thirtythousandtwohundredninetyseven -- links -> eleventhousandeighthundredsixtysix;
eleventhousandtwohundredsixtyfive -- links -> fortyeightthousandninehundredninety;
twentyeightthousandseventysix -- links -> fortytwothousandonehundredtwentythree;
fortyseventhousandfivehundredtwentyfive -- links -> twentyninethousandseventy;
twothousandfivehundredsix -- links -> twentythreethousandtwohundredthirtyseven;
thirtythreethousandninehundredtwentythree -- links -> fortythousandtwohundredseven;
fifteenthousandeighthundredtwentyseven -- links -> fivethousandonehundredseventyone;
thirtythousandonehundredsixtyeight -- links -> twothousandfivehundredeighty;
thirtytwothousandfivehundredeightyfour -- links -> twentyonethousandtwohundredthirtythree;
twentytwothousandonehundredtwentythree -- links -> seventhousandfivehundredseventyone;
sixthousandthreehundredninetyeight -- links -> sixthousandtwentythree;
thirtyeightthousandsevenhundredfiftyfour -- links -> fourthousandsevenhundredeightyeight;
fortyfivethousandthreehundredfiftynine -- links -> fortyfourthousandfourhundredsixtyfour;
eleventhousandonehundredninetyeight -- links -> fourteenthousandfivehundredtwenty;
thirtythreethousandsevenhundredtwentyfive -- links -> fivethousandfivehundredtwentynine;
twentyonethousandsixhundredtwenty -- links -> twentyninethousandfourhundredseventynine;
twentyninethousandtwohundredeightythree -- links -> thirtythousandtwohundredninetytwo;
onethousandtwohundredseventytwo -- links -> fortyeightthousandsixhundredfiftyeight;
sixteenthousandsixhundredeighteen -- links -> twentyeightthousandonehundredforty;
fortyninethousandonehundredsixty -- links -> fortyseventhousandsevenhundredthirtyfive;
thirtyeightthousandfourhundredfiftythree -- links -> thirtyfivethousandfiftynine;
nineteenthousandonehundredeightysix -- links -> thirtysixthousandthreehundredthirtyeight;
thirtythreethousandsevenhundredseventy -- links -> fortythreethousandsixhundredtwentyfour;
twentyfivethousandfivehundredseven -- links -> twentyfourthousand;
thirtyninethousandeighthundredfiftyfour -- links -> fortyfivethousandtwohundredsixtyeight;
twentyfourthousandsixhundredeightyfive -- links -> fortyeightthousandtwohundredfiftyfive;
twentythreethousandsixhundredfiftynine -- links -> thirtyeightthousandfivehundredthirtyone;
thirteenthousandninehundredtwentyfour -- links -> twentyninethousandten;
twentyninethousandeighthundredseventytwo -- links -> twentytwothousandonehundredfortyfour;
eleventhousandsevenhundredthirtyfour -- links -> twelvethousandsixhundredtwentyfive;
fortyeightthousandsixhundredfortysix -- links -> eleventhousandfortyeight;
fortythousandtwohundredtwentynine -- links -> twentyonethousandsevenhundredeightyeight;
onethousandthreehundredfiftyfour -- links -> tenthousandsevenhundredsixtynine;
fortyseventhousandsixhundredeighteen -- links -> fortytwothousandonehundredtwentyeight;
fivethousandeighthundredeightythree -- links -> thirtyfourthousandthreehundredfiftysix;
fortyonethousandeighthundredfortyseven -- links -> fortyonethousandsevenhundredsixtytwo;
fortyninethousandfourhundredten -- links -> fourthousandeighthundredeightyfive;
twentyninethousandfourhundredforty -- links -> sevenhundredfortyfive;
twentytwothousandninehundredthirtyseven -- links -> fourteenthousandsevenhundredtwentythree;
seventeenthousandeighthundredfifteen -- links -> fortyninethousandthreehundredsixtyeight;
thirtytwothousandfourhundredseventyfour -- links -> fortythreethousandfivehundredseventynine;
thirtyonethousandninehundredsixteen -- links -> fortyfivethousandfourhundredfortynine;
fortysixthousandthreehundredtwentyfive -- links -> twentyfivethousandninehundredeleven;
twentythreethousandonehundredninetyseven -- links -> fortyeightthousandtwohundredseventyseven;
thirtyonethousandsevenhundredeightynine -- links -> fortyonethousandeighthundredtwelve;
thirteenthousandeighthundredfortyeight -- links -> thirtysixthousandonehundredninetyone;
twentythousandthreehundredninetynine -- links -> twentyninethousandonehundredeightyfive;
thirtytwothousandfourhundredfortytwo -- links -> eightthousandeighthundredsixteen;
twentyseventhousandninehundredthirtysix -- links -> thirtythreethousandeighthundredeleven;
twentyfivethousandfourhundredfiftyeight -- links -> thirtyeightthousandtwohundredsixtynine;
fortyfivethousandsixhundredfiftyone -- links -> twentyfourthousandfivehundredfortynine;
seventeenthousandsixhundredseventyone -- links -> fourthousandonehundredninetyeight;
fifteenthousandsevenhundredsixtythree -- links -> fortyninethousandsixhundredthirteen;
fivethousandsixhundredthirtyfour -- links -> twentyninethousandsixhundredeight;
twentyfourthousandfivehundredfortyseven -- links -> fortyonethousandeighthundredsixtysix;
twentyeightthousandtwentysix -- links -> thirtyfivethousandthreehundredninetythree;
fortyeight -- links -> twentysixthousandsixhundredthirtythree;
twentythreethousandonehundredfortysix -- links -> fortythousandfivehundredfortyseven;
sixthousandsixhundredseven -- links -> fortyseventhousandsevenhundredsixtyseven;
fortyfourthousandeighthundredninetyseven -- links -> twentyeightthousandsevenhundredsix;
twentyseventhousandsixhundredforty -- links -> tenthousandtwohundrednine;
fortytwothousandthreehundredten -- links -> twelvethousandfourhundredtwentythree;
fivethousandeighthundredthirtynine -- links -> twothousandonehundredthree;
fortysixthousandeighthundredfiftyfour -- links -> twentyonethousandsevenhundrednineteen;
sixthousandfortythree -- links -> nineteenthousandsixhundredfortyseven;
fortyninethousandfourhundredfour -- links -> eightthousandsevenhundredeightytwo;
fortysixthousandonehundredsixtyfour -- links -> tenthousandsixhundredthirteen;
twothousandsixhundredfiftyone -- links -> fortyfourthousandtwentyone;
twentythreethousandninehundredthirtyfour -- links -> fivethousandsixhundredeighty;
nineteenthousandeighthundrednineteen -- links -> ninethousandtwohundredninetyeight;
seventhousandonehundredeighty -- links -> twentyninethousandfourhundredtwentyfour;
sixteenthousandfourhundredninetythree -- links -> eighteenthousandtwohundredseventyone;
seventhousandfivehundredfiftyfive -- links -> fivethousandonehundredfiftysix;
eleventhousandfourhundredfive -- links -> thirtyninethousandeleven;
fortyeightthousandninehundredfiftyseven -- links -> thirtyseventhousandeighthundredsixteen;
nineteenthousandfourhundredninetyone -- links -> twentyninethousandfourhundredsixtyeight;
twentyninethousandninehundredninetyone -- links -> thirtythreethousandonehundredseventynine;
twentythousandthreehundredfortytwo -- links -> fortyeightthousandsevenhundredeightytwo;
fourthousandthirtynine -- links -> onethousandninehundredeighteen;
eightthousandeighthundredseventyeight -- links -> thirtyfivethousandtwohundredtwenty;
thirtyfourthousandeighthundredtwentynine -- links -> seventhousandonehundredninetythree;
fortythousandthreehundredfiftysix -- links -> thirtyseven;
twentytwothousandsixhundredtwentyeight -- links -> twentysixthousandsevenhundredninetytwo;
fortyeightthousandonehundredfour -- links -> thirtysixthousandonehundredfifteen;
fortythreethousandthirteen -- links -> twentyeightthousandfivehundredthirty;
twentyfourthousandonehundredseventyfour -- links -> eleventhousandonehundredthirtythree;
eleventhousandsixhundredfortyone -- links -> thirtyfourthousandsixhundredthirtyfour;
sixthousandseventyone -- links -> seventeenthousandthreehundredfortynine;
fourthousandfivehundredfive -- links -> seventeenthousandseventy;
ninethousandninehundredninetyone -- links -> twothousandthreehundredninetyfive;
twentyeightthousandsevenhundredforty -- links -> seventeenthousandsixhundredtwentynine;
fortythreethousandonehundredninetytwo -- links -> thirtyfourthousandfivehundredeightythree;
thirtyeightthousandeighthundredtwentyeight -- links -> fortysixthousandtwohundredfortysix;
twentyninethousandsixhundredfiftynine -- links -> onethousandonehundredtwentysix;
thirtyninethousandtwohundredsixtyone -- links -> sixteenthousandtwohundredninetynine;
eightthousandtwohundredseventyeight -- links -> fortyfivethousandthreehundredfiftysix;
seventhousandthreehundredtwentythree -- links -> thirtyonethousandsevenhundredsixteen;
thirteenthousandfourhundredthirtyeight -- links -> fortyonethousandsevenhundredfour;
seventhousandninetyfive -- links -> twentyeightthousandfivehundredtwelve;
fivethousandsixhundredfifty -- links -> seventeenthousandfivehundrednine;
fourteenthousandsixhundredsixtynine -- links -> fortytwothousandfivehundredeightytwo;
thirtythreethousandninehundredfiftythree -- links -> twentythousandtwohundredfiftytwo;
twentyonethousandthreehundrednine -- links -> thirtyfivethousandsixtysix;
fourteenthousandtwohundredeighteen -- links -> twentyonethousandfourhundredsixtythree;
twentyfourthousandsixhundredtwentynine -- links -> fortyfivethousandonehundredsixteen;
twentyonethousandeighthundredeightysix -- links -> twentyfourthousandfourhundredthirtythree;
fortyfivethousandfourhundredthirtyone -- links -> thirtythreethousandfourhundredthirtyfour;
thirtyonethousandfivehundredtwentyfour -- links -> ninehundredfiftythree;
twelvethousandsixhundredsixtyeight -- links -> sixthousandeighthundredfiftythree;
tenthousandeighthundredeightynine -- links -> fortyseventhousandeighthundredfortyfive;
fortyseventhousandeighthundredsixtyone -- links -> thirtysixthousandninetyseven;
thirtythreethousandnine -- links -> twothousandsixhundredninety;
twentyeightthousandseventythree -- links -> fivehundredsixtyfive;
thirtyfourthousandfivehundredtwentyseven -- links -> tenthousandthreehundredthirty;
thirtythreethousandeightyeight -- links -> sevenhundredtwentythree;
thirtyseventhousandfourhundredthirtysix -- links -> twentyfourthousandfivehundredfortythree;
fourteenthousandfourhundredninety -- links -> ninethousandthreehundredfourteen;
thirtyninethousand -- links -> threethousandninehundredseventyone;
fourthousandfivehundredtwentyfive -- links -> threethousandsixhundredthirtyeight;
fourteenthousandninehundredsix -- links -> eighteenthousandninehundredfiftyfour;
sixhundredfifty -- links -> sixteenthousandninehundredsixtyone;
thirtyseventhousandeighthundredfortyfive -- links -> eighteenthousandfivehundrednineteen;
fortyonethousandfourhundredeightythree -- links -> fifteenthousandsevenhundredseventynine;
sixthousandthreehundredfourteen -- links -> eighteenthousandtwohundredtwentyseven;
fortyseventhousandfourhundrednineteen -- links -> nineteenthousandninehundredsixtyfive;
fortytwothousandfourhundredfour -- links -> fivethousandonehundredeightyone;
fortyninethousandsixhundredfortynine -- links -> threehundredfiftysix;
twentyonethousandsixty -- links -> thirtyninethousandninehundredninetyfive;
nineteenthousandsixhundredeleven -- links -> thirtyfivethousandeighthundredtwentyfour;
thirtyfourthousandthreehundredsixtyone -- links -> fortythousandsixhundredfiftyfour;
thirtyseventhousandsixhundrednineteen -- links -> twentytwothousandfivehundredeighty;
twentythreethousandfivehundredthirtyone -- links -> fortythreethousandsixhundredfour;
fortythreethousandeighthundredeightyeight -- links -> twentyeightthousandfivehundredthirtysix;
thirtythousandfive -- links -> twentyninethousandsixhundredseventy;
twelvethousandthreehundredthirtytwo -- links -> twelvethousandeighthundredfifty;
twentyfourthousandtwentynine -- links -> fortythreethousandfiftyeight;
fourthousandonehundredeightynine -- links -> fortyfourthousandninetynine;
tenthousandonehundredsixtyone -- links -> thirtyseventhousandthreehundredsixtythree;
thirtyfourthousandsevenhundredseventyone -- links -> twentythreethousandsixtynine;
sixteenthousandonehundredseventyfive -- links -> thirtysixthousandeighthundredtwelve;
twentyfourthousandninehundredfiftyseven -- links -> thirtyseventhousandninehundredsix;
twelvethousandthreehundredfiftytwo -- links -> thirtyonethousandtwohundredfiftytwo;
eighteenthousandfourhundredeightyeight -- links -> thirteenthousandfourhundredeighty;
sixthousandsevenhundredseven -- links -> nineteenthousandeighthundredsixtysix;
twentyonethousandonehundredeightynine -- links -> twelvethousandtwohundredone;
nineteenthousandtwohundredthirtyfour -- links -> ninethousandonehundredseventyeight;
twentytwothousandfourhundredtwentyone -- links -> thirtyninethousandsevenhundredfiftyone;
seventhousandthreehundredsixtythree -- links -> onethousandeighthundredfortyeight;
fortytwothousandfourhundredninetynine -- links -> seventhousandsevenhundredeightynine;
thirtysixthousandninehundredeightynine -- links -> thirtyninethousandfourhundredfortynine;
thirtyonethousandninehundredthree -- links -> twentyninethousandtwohundredsixtyfour;
thirtyfourthousandsevenhundredtwentyfive -- links -> tenthousandthirtyfour;
thirtyonethousandfivehundredfiftyfive -- links -> fortythreethousandtwohundredthirtysix;
thirtythousandthreehundredeightyeight -- links -> thirtyeightthousandsixhundredthirtytwo;
thirtythreethousandfiftynine -- links -> eightthousandninehundredseven;
thirtytwothousandtwohundredninetyfour -- links -> twentyfourthousandfiftyfour;
thirtyfourthousandeighthundredseventy -- links -> fortysixthousandthreehundredninetytwo;
thirtyonethousandsixhundredeightytwo -- links -> ninethousandsixhundredtwentyeight;
fortyfourthousandeighthundredseventyfive -- links -> onethousandfivehundredthirtyeight;
twentythousandthreehundredfive -- links -> fifteenthousandonehundredseventytwo;
eightthousandninety -- links -> fortyseventhousandthreehundredeighty;
twentyfivethousandsevenhundredfortyone -- links -> twentyeightthousandninehundredseventyseven;
thirteenthousandthreehundredeightyfive -- links -> fourteenthousandonehundredfortyfive;
twentythousandeightyeight -- links -> twentyfourthousandthreehundredtwenty;
fourteenthousandsevenhundredninetyone -- links -> thirtytwothousandtwohundredtwentynine;
eighteenthousandfiftythree -- links -> fortyonethousandsixhundredsixteen;
fortyninethousandninetysix -- links -> twentythousandeighthundredseventy;
sixthousandeightysix -- links -> twentyonethousandsevenhundredtwentysix;
thirtythreethousandeighthundredfiftyfour -- links -> thirtyonethousandsixtyfive;
thirtyfivethousandfivehundredseventytwo -- links -> fortyseventhousandtwohundredtwentyfive;
thirtythreethousandninehundredthirtysix -- links -> thirtyninethousandsixhundredsixtyfive;
twentyninethousandsixhundredfive -- links -> twentyonethousandtwohundredsixtynine;
thirtyonethousandthreehundredtwentytwo -- links -> twentythreethousandeighthundredfiftynine;
ninethousandfivehundredfortynine -- links -> fortyeightthousandsixhundredfiftyone;
eightthousandfourhundredsixtyfour -- links -> twentyfourthousandthreehundredseventythree;
fortysixthousandnineteen -- links -> twentytwothousandninehundredfiftyseven;
twentytwothousandfourhundred -- links -> twentythousandthreehundredeight;
sixthousandsevenhundredtwo -- links -> nineteenthousandsixhundredsix;
twentyeightthousandtwohundredseventyfive -- links -> twentysixthousandfivehundredthirtythree;
twentyfivethousandsevenhundrednine -- links -> twentysixthousandthreehundredthirtysix;
fortysixthousandthreehundredfiftytwo -- links -> fortyeightthousandeighthundredfiftyone;
seventhousandfivehundredtwenty -- links -> twentyfourthousandthreehundredfiftytwo;
fortyfourthousandsixhundredeightysix -- links -> fivethousandsixhundredtwentythree;
twentythousandtwentytwo -- links -> fortyseventhousandthreehundredthirtynine;
eightthousandfourhundredthree -- links -> thirtyfivethousandonehundredseventyfour;
onethousandonehundredthirtynine -- links -> fortyeightthousandonehundredforty;
fourthousandeighthundredseventyseven -- links -> twothousandtwohundredtwelve;
eightthousandsixhundredseventy -- links -> twentyeightthousandninehundredfiftyeight;
thirtyfourthousandonehundredfiftysix -- links -> thirtysixthousandthirtyeight;
threethousandthreehundredsixtyfive -- links -> twentyninethousandfourhundredninetyone;
ninethousandeighthundredsixtyseven -- links -> tenthousandfivehundredone;
thirtyfourthousandninehundredseventythree -- links -> tenthousandtwohundredthirtyone;
twentythreethousandfourhundredone -- links -> twentyfivethousandfivehundredninetynine;
eightthousandthreehundredthirteen -- links -> thirtyeightthousandtwohundredfiftyfive;
twelvethousandsevenhundredseventysix -- links -> ninethousandfourhundredthirtyone;
fourteenthousandthreehundredten -- links -> twentysixthousandfortythree;
twentyninethousandsixhundredsixtysix -- links -> fortyonethousandfourhundredsixtyeight;
thirtyfourthousandfourhundredeightytwo -- links -> twentythousandsevenhundredninetyfive;
thirtyseventhousandonehundredthirtyeight -- links -> eleventhousandninehundredtwentyseven;
eightthousandsevenhundredninetyone -- links -> fourhundredsixtyone;
seventeenthousandonehundredfiftyeight -- links -> tenthousandninetyfive;
thirteenthousandtwohundredthirtynine -- links -> fortyfourthousandonehundredninetysix;
fortyninethousandsevenhundredtwentyseven -- links -> fortyfivethousandfivehundredeleven;
onehundredseventeen -- links -> twentysixthousandfivehundred;
fortyfourthousandfifty -- links -> fortythousandthreehundredten;
eleventhousandonehundredtwo -- links -> fivethousandfourhundredeightytwo;
thirtytwothousandfivehundredeleven -- links -> thirteenthousandtwohundredtwentythree;
tenthousandninehundredthirty -- links -> fortysixthousandfiftyseven;
thirtyonethousandonehundredninetyfive -- links -> thirtyseventhousandsixhundredtwentythree;
twentyninethousandfourhundredeleven -- links -> thirtyfourthousandninetyfive;
fourteenthousandsixhundredeightyfour -- links -> thirtyonethousandninehundredthirtyone;
thirteenthousandtwohundrednine -- links -> fortytwothousandtwohundredfortysix;
thirtytwothousandfourhundred -- links -> thirtythousandsevenhundredeight;
thirtythousandsixhundredseven -- links -> fortysixthousandthreehundredten;
twentyfourthousandfourhundredseventyfour -- links -> thirteenthousandthree;
seventeenthousandfiftythree -- links -> eleventhousandsixhundredfiftyfive;
thirtysixthousandfivehundredseventyone -- links -> nineteenthousandfourhundredninetyfive;
ninethousandfivehundredseven -- links -> twentythreethousandtwohundredeightyfive;
thirtyeightthousandnine -- links -> twentyninethousandsixhundredseventyeight;
twelvethousandsixhundredtwentythree -- links -> twentythousandninehundredeightyeight;
fourthousandsevenhundredthirtyfour -- links -> twentyonethousandfivehundredtwentyseven;
twentysixthousandsixhundredfour -- links -> thirteenthousandsevenhundredfifteen;
fortythreethousandsixhundredsixtyfour -- links -> fortyonethousandfourhundredfive;
eleventhousandtwohundredseventyone -- links -> thirtythousandninehundredseventeen;
ninethousandonehundredtwentyeight -- links -> twelvethousandsixhundredeight;
fivethousandsixhundredfourteen -- links -> fortyninethousandfourhundredeighteen;
eleventhousandninehundredseventy -- links -> thirtytwothousandeightysix;
fifteenthousandfourhundred -- links -> twentyfivethousandninehundredtwentyfour;
twentyseventhousandseventytwo -- links -> fortyninethousandthreehundredfiftynine;
twentyfivethousandsixhundredfortythree -- links -> seventeenthousandninehundredeightynine;
thirtyeightthousandninety -- links -> twentyfourthousandonehundredthirtyfour;
sixteenthousandthreehundredfifty -- links -> thirtytwothousandsevenhundredeightytwo;
eleventhousandfivehundredten -- links -> fortyonethousandsevenhundredfortyseven;
fifteenthousandsixhundredtwentyseven -- links -> twentyninethousandsevenhundredninetyfour;
thirtyseventhousandninehundredfiftytwo -- links -> fortyonethousandsixhundredthirteen;
fortyeightthousandninehundredseventysix -- links -> fortyfourthousandfiftyeight;
twentyseventhousandthreehundredeightytwo -- links -> twentyonethousandtwohundredsixtyone;
thirtythreethousandthreehundredseventynine -- links -> twentytwothousandfourhundredninetyseven;
tenthousandninetynine -- links -> fortythreethousandtwohundredfortysix;
fortythousandsixhundredtwentyfour -- links -> twentyseventhousandsevenhundredninetyone;
thirtyeightthousandfivehundredtwo -- links -> fourhundredthirtytwo;
tenthousandonehundredseventysix -- links -> fortyonethousandonehundredthirtynine;
fortyfivethousandthreehundredfortytwo -- links -> thirtyfourthousandeighthundredninetyone;
twentyfourthousandthirtynine -- links -> fortyseventhousandonehundredfortysix;
eightthousandfivehundred -- links -> twelvethousandeighthundredsixtyfive;
thirtyfourthousandseventyfour -- links -> sixteenthousandfourhundredsixty;
thirtyonethousandonehundredeightynine -- links -> fortyonethousandonehundred;
thirtyeightthousandsixhundredeightyfour -- links -> thirtytwothousandonehundredsixtyfive;
thirteenthousandfivehundredsixtytwo -- links -> seventhousandninehundredninetyone;
twentythousandfourhundredfiftytwo -- links -> twentyfourthousandfourhundredeightyone;
twentyeightthousandsixhundredninetyfour -- links -> thirtyfourthousandfourhundredfortyone;
fortythreethousandsixhundredseventysix -- links -> fortyeightthousandninehundredtwentynine;
fortyfivethousandsevenhundredeight -- links -> thirtyfivethousandninehundredfortyseven;
fortyfivethousandninehundredninetytwo -- links -> seventhousandfourhundredthirtyfour;
thirtysixthousandfivehundredseventyone -- links -> thirtyonethousandninehundredninetyfive;
seventhousandninehundredfour -- links -> eightthousandsevenhundredsixtyfour;
thirteenthousandeighthundredfortyseven -- links -> fortytwothousandfivehundredtwentyone;
ninethousandfivehundredeighty -- links -> thirtysixthousandfivehundredtwelve;
thirtyfivethousandfourhundredninetytwo -- links -> fourteenthousandninehundredninetyone;
fortysixthousandninehundredtwentyfour -- links -> twelvethousandeighthundredfortythree;
twentysixthousandfourhundredseventeen -- links -> fortythreethousandonehundredfortynine;
twentyeightthousandfivehundredtwentynine -- links -> fortysixthousandtwohundredeightyeight;
ninethousandninehundredninetynine -- links -> thirtyninethousandsixhundredtwo;
thirtythousandsevenhundredseventynine -- links -> fortytwothousandfivehundredsixtyone;
seventeenthousandeighthundredsixtynine -- links -> twentyeightthousandninehundredeightythree;
fortytwothousandonehundredninetytwo -- links -> fortyseventhousandfivehundredseventythree;
thirtythreethousandfivehundredsix -- links -> eighthundredtwentyone;
twentyonethousandfourhundredfortysix -- links -> eighteenthousandninehundredsixtyfive;
twothousandfourhundredtwentyone -- links -> fourthousandsixhundredseventynine;
fortythousandeighthundredseventyseven -- links -> thirtythousandsixhundredfiftyseven;
thirtyfivethousandtwohundredninetytwo -- links -> fifteenthousandsixhundredten;
twentysixthousandtwelve -- links -> thirtyseventhousandninehundredtwenty;
thirtytwothousandthreehundredsixtyeight -- links -> thirtyonethousandthreehundredfortyfour;
thirtyeightthousandsixhundredseventyeight -- links -> thirtyeightthousandonehundredthirtytwo;
fortythreethousandtwohundrednine -- links -> fortyseventhousandeighthundredtwelve;
tenthousandsevenhundredseventyseven -- links -> ninethousandonehundredsixtyfour;
twentyonethousandtwohundredseventyfive -- links -> seventhousandsevenhundredtwenty;
thirtyseventhousandninehundredeightyseven -- links -> onethousandtwohundredfiftyone;
eighteenthousandsevenhundredeightyone -- links -> thirtyfivethousandfiftyone;
fortythousandninehundredsixty -- links -> fortyeightthousandeightyfive;
fortyseventhousandeighthundredfiftyeight -- links -> twentythousandsevenhundredninety;
thirtysixthousandfive -- links -> twentyfivethousandninehundredeightysix;
thirteenthousandninehundredfortyone -- links -> nineteenthousandonehundredtwentyfive;
eleventhousandeighthundredseventyfive -- links -> twentysixthousandfourhundredfortythree;
twentyeightthousandninehundredsixtysix -- links -> thirtytwothousandtwohundredfortythree;
fortyninethousandtwohundredtwentyfour -- links -> thirtytwothousandthreehundredthirty;
ninehundredtwentythree -- links -> thirtytwothousandeighthundredthirty;
fortyfivethousandeighthundredseventynine -- links -> thirtyonethousandfourhundredsix;
thirtyseventhousandsixhundredfive -- links -> fivethousandsixtyfive;
fifteenthousandonehundredseventy -- links -> fortyninethousandsixhundredthirtyfive;
twentyfivethousandeighthundrednine -- links -> sixthousandthreehundredsixtyeight;
fivethousandfourhundredten -- links -> fortyonethousandforty;
twentyfourthousandtwohundredsixtytwo -- links -> twentyninethousandthreehundredninetyeight;
twentyninethousandninehundredeight -- links -> fifteenthousandsixhundredfortytwo;
sixteenthousandsixhundredseventyfour -- links -> sixteenthousandeighthundredseventyfive;
twelvethousandtwohundredthirtynine -- links -> thirtyeightthousandfourhundredsix;
tenthousandfivehundredtwentyfour -- links -> twentytwothousandonehundredfive;
fortythreethousandfivehundredeightynine -- links -> fortysixthousandthreehundredfortyeight;
eighteenthousandsixhundredsixtyone -- links -> onethousandsevenhundredtwentysix;
fortyninethousandfourhundredthirty -- links -> twentytwothousandninehundredsixtyseven;
ninethousandfourhundredfortyone -- links -> threethousandsevenhundred;
seventhousandfivehundredsixteen -- links -> sixthousandonehundredtwentyone;
seventeenthousandfourhundredninetynine -- links -> eleventhousandfourhundrednineteen;
twothousandtwohundredthirtyone -- links -> fortythreethousandninetynine;
thirtyninethousandeighteen -- links -> thirtyseventhousandfourhundredthirtytwo;
onethousandsixhundredfive -- links -> thirtytwothousandfourhundredfortynine;
twentyonethousandninehundredsixtysix -- links -> tenthousandsix;
fortyseventhousandsixhundredninetytwo -- links -> fortythreethousandfivehundred;
fortysixthousandfiftyfour -- links -> eightthousandfourhundredninetyone;
thirtyeightthousandtwohundredthirtytwo -- links -> thirtyseventhousandsevenhundredthirtyseven;
fortythousandninetyeight -- links -> twelvethousandthreehundredseventyfour;
sixthousandonehundredforty -- links -> twentythreethousandninehundredtwelve;
twentyninethousandfourhundredeightyeight -- links -> eightthousandfivehundredsixteen;
thirtythousandfourhundredsix -- links -> threethousandeighthundredninetyfive;
thirteenthousandthreehundredeighteen -- links -> thirtytwothousandfourhundredninetyeight;
fortyseventhousandeighthundredfortyfour -- links -> twentyfourthousandfourhundredtwentyeight;
threethousandtwohundredtwentyseven -- links -> thirtyfivethousandonehundredfortynine;
threethousandsevenhundredeightynine -- links -> sixthousandonehundredtwentynine;
thirtyeightthousandonehundredseventyseven -- links -> thirtytwothousandeighthundredthirtyseven;
fortyfourthousandsixhundredthirtyeight -- links -> eightthousandtwohundredfifty;
nineteenthousandfourhundredfortytwo -- links -> fortysixthousandfourhundredeighty;
twelvethousandthreehundredeightyfive -- links -> thirtythreethousandtwohundredthirtyfour;
thirtyfourthousandsevenhundredfiftynine -- links -> thirtyseventhousandsixtyseven;
fortythreethousandsixhundredtwentyseven -- links -> twentyfivethousandsevenhundredthirtyone;
twentyseventhousandeighthundredeightyseven -- links -> onehundredeightyseven;
thirtyninethousandsevenhundredsixtythree -- links -> thirtyfourthousandfivehundredsixtyfive;
twentyseventhousandonehundredtwentytwo -- links -> fortyonethousandfourhundredfortyone;
thirtyfivethousandfivehundredsixtytwo -- links -> fortyseventhousandseventy;
threethousandonehundredeightyseven -- links -> fortyseventhousandfourhundredfiftyone;
thirtyfivethousandthirtyfive -- links -> twentythousandninehundredfiftyone;
twentysixthousandsevenhundredthirtyone -- links -> thirtyseventhousandtwohundredfiftysix;
fortythousandsixhundredeightynine -- links -> thirtytwothousandthreehundredthirtyfive;
thirtysixthousandthreehundredseventyfive -- links -> fortyfivethousandninehundredeight;
thirtythousandsixhundredseven -- links -> twentytwothousandthreehundredseventysix;
eleventhousandthreehundredseventysix -- links -> thirtyfourthousandfourhundredeightyone;
fortysixthousandsixhundredforty -- links -> ninethousandninehundredthree;
thirtysixthousandsevenhundredseven -- links -> fortyseventhousandfivehundredtwentysix;
thirtytwothousandsevenhundredsixtyfour -- links -> fortyfivethousandtwohundredten;
twentytwothousandtwentynine -- links -> twentytwothousandonehundredninetythree;
thirtysixthousandfivehundredninetyfive -- links -> fivethousandonehundredthirty;
fortyeightthousandsixhundredsixtyone -- links -> fivethousandthreehundredthirtyseven;
twentyfivethousandfourhundredeightyone -- links -> fortythousandeighthundredsixtyfour;
sixthousandthreehundredten -- links -> thirtytwothousandfivehundredninetyone;
tenthousandonehundredfortytwo -- links -> thirtyeightthousandfourhundredtwelve;
twentysixthousandtwohundredfortyseven -- links -> onethousandtwentysix;
twentyonethousandfivehundredsixtyone -- links -> fivethousandsevenhundredfortyfour;
thirtythousandtwentyfour -- links -> twentyninethousandeighthundredseventythree;
thirtytwothousandeighthundred -- links -> fortyeightthousandsevenhundredthirtynine;
onethousandsevenhundredseven -- links -> twothousandfourhundredeleven;
onehundredthree -- links -> fortyninethousandthreehundredseventyseven;
twentyninethousandsevenhundredfortyone -- links -> fourthousandeighthundredthirtyfour;
fortyeightthousandtwohundredseventyfour -- links -> eightthousandninehundredsixty;
fortythreethousandninehundredthirtysix -- links -> eightthousandsixhundredtwentytwo;
thirteenthousandsixhundredfiftyseven -- links -> thirtyfourthousandfivehundrednine;
twentyonethousandfourhundredfortysix -- links -> thirtyfivethousandsevenhundredninety;
threethousandsevenhundredthree -- links -> threethousandninehundredseventythree;
eleventhousandsixhundredsixty -- links -> fortyninethousandonehundredsixtytwo;
thirtyninethousandfourhundredtwentythree -- links -> onethousandninehundredtwenty;
seventeenthousandsixhundredsixtyfour -- links -> thirtytwothousandsixhundredninetytwo;
fivethousandonehundredsixteen -- links -> twentythousandfivehundredninetynine;
threethousandtwohundredninetyseven -- links -> twentythousandfivehundredeight;
eleventhousandthreehundredninetyfour -- links -> sixteenthousandthreehundredfortytwo;
thirtyfourthousandeighthundredeightytwo -- links -> sixthousandsevenhundredfiftyfive;
fivehundredninetyeight -- links -> twentyfourthousandsevenhundredone;
fortyonethousandonehundredninetyfour -- links -> thirtyfourthousandfourhundredseventyone;
sixteenthousandsixhundredseventynine -- links -> fortyfourthousandthreehundredfiftytwo;
thirtythousandtwohundrednineteen -- links -> twentyseventhousandeighthundredtwenty;
thirteenthousandonehundredfortyfour -- links -> fortythreethousandtwohundredthirty;
thirtyninethousandfivehundredfortyeight -- links -> thirtyfourthousandeighthundredninetytwo;
seventeenthousandsevenhundredfiftysix -- links -> thirtyeightthousandsevenhundredeightythree;
thirtyonethousandninehundredfortytwo -- links -> thirtythousandeighthundredthirtyeight;
twentyonethousandfour -- links -> twentyonethousandsixhundredseven;
thirtyfivethousandfourhundredfifteen -- links -> sixthousandfifty;
twentysixthousandninehundredfiftyone -- links -> fortysixthousandonehundrednineteen;
fourteenthousandfourhundredseven -- links -> sixthousandninehundredthirtytwo;
fortyseventhousandthreehundredninetynine -- links -> thirtyninethousandeighthundredeleven;
twentyseventhousandeighthundredfortyfive -- links -> fivethousandthirtynine;
fortyninethousandeighthundredeightyfour -- links -> twelvethousandninetythree;
thirtysixthousandthreehundredninetysix -- links -> sixhundredforty;
thirtythreethousandonehundredtwentyseven -- links -> seventhousandseventytwo;
seventhousandonehundredseventyfive -- links -> thirtysixthousandsevenhundredseventynine;
twelvethousandsevenhundredtwentyfive -- links -> eleventhousandtwohundredtwentyfive;
eleventhousandtwohundredninetyfour -- links -> twentyfourthousandsevenhundredeightyeight;
onethousandsixhundredsix -- links -> sixthousandfourhundredninetysix;
eighteenthousandsixhundredfiftythree -- links -> twentythousandsevenhundredforty;
eighteenthousandfivehundredfive -- links -> twentyeightthousandninehundredfortyeight;
thirtyonethousandsevenhundredtwentyseven -- links -> thirtysixthousandthreehundredfifteen;
fortytwothousandtwohundredthirty -- links -> nineteenthousandtwohundredsixtyeight;
ninethousandsevenhundredtwentyfour -- links -> twentyninethousandfivehundredseventytwo;
fivehundredninetynine -- links -> onethousandthreehundredeightyseven;
fortyfourthousandninehundredfiftysix -- links -> threethousandfivehundredfiftysix;
fourthousandonehundred -- links -> fortyfivethousandtwohundrednineteen;
onethousandsevenhundredthree -- links -> sixteenthousandfourhundredtwentyeight;
thirtysixthousandnine -- links -> twentysixthousandfivehundredthirtyseven;
twentyeightthousandeighthundredten -- links -> fifteenthousandfourhundredfiftyfive;
twentyseventhousandsixhundredfiftyfour -- links -> thirtyonethousandthreehundredninetythree;
twentytwothousandtwohundredsixteen -- links -> fortysixthousandfivehundredfortyone;
fivethousandfivehundredeight -- links -> sixthousandsixteen;
eighteenthousandsixhundredthirtyfive -- links -> fortytwothousandeighthundredsixtyone;
fivethousandsixhundredsixtythree -- links -> fortyeightthousandfourhundredforty;
nineteenthousandfivehundredfortyone -- links -> thirteenthousandsixhundredfortyone;
twentythousandfivehundred -- links -> fortyfourthousandonehundredtwentynine;
sixteenthousandtwohundredsixteen -- links -> thirtyeightthousandonehundredfifteen;
onethousandonehundredtwelve -- links -> twentyninethousandfourhundredseventythree;
fourthousandeighthundredsixtyone -- links -> twentyseventhousandsixhundredfiftyfour;
eighthundredthirtyfour -- links -> fivethousandeighthundredsix;
threehundredfortyone -- links -> seventhousandeighthundredninetyfive;
seventhousandfourhundredthirty -- links -> tenthousandtwohundredfiftyone;
thirtythreethousandninehundredfortysix -- links -> tenthousandonehundredsix;
twentythreethousandthreehundredfortythree -- links -> fortyninethousandeighthundredthirtynine;
fortyseventhousandsixhundredseventeen -- links -> twentythousandfourhundredninetyseven;
twentyonethousandtwohundredseventythree -- links -> fourteenthousandfiftyone;
fifteenthousandninehundredthree -- links -> nineteenthousandeighthundredseventyone;
eighteenthousandninehundredsixtyeight -- links -> eighteenthousandninehundredsixtynine;
threethousandfivehundredfiftyseven -- links -> twentyfivethousandfivehundredfifteen;
thirtyfivethousandfivehundredtwelve -- links -> fourthousandfivehundredeightysix;
thirtyninethousandeighthundredseventeen -- links -> fourteenthousandfortyeight;
fifty -- links -> fourthousandtwohundred;
twentytwothousandfivehundredfourteen -- links -> twentythousandeightyone;
fivethousandtwohundredseven -- links -> eleventhousandsixhundredeightytwo;
fortyfivethousandninehundredfiftytwo -- links -> twentyeightthousandfourhundredninety;
fivethousandtwohundredtwelve -- links -> thirtythreethousandonehundredninety;
twentyfourthousandfivehundredseventeen -- links -> fortyonethousandninehundredeightyfive;
fifteenthousandsixhundredninetyeight -- links -> fivethousandsevenhundredtwelve;
twothousandfourhundredthirtysix -- links -> twentyfourthousandtwentyeight;
fortysixthousandsixhundredseventythree -- links -> fortytwothousandfourhundredthirtythree;
thirtyfivethousandfourhundredninetythree -- links -> fortytwothousandninehundredseventytwo;
twelvethousandfivehundredninetythree -- links -> fortythreethousandthreehundredeightyseven;
twelvethousandonehundredseventyeight -- links -> thirtysixthousandtwohundredfourteen;
twelvethousandtwohundredtwentynine -- links -> fortyfourthousandfourhundredtwentyfour;
fortytwothousandthreehundredfiftythree -- links -> thirteenthousandonehundredseventyone;
thirtysixthousandthirtysix -- links -> twelvethousandfivehundredtwentythree;
thirteenthousandninehundredeightyone -- links -> nineteenthousandfivehundredeightyone;
thirteenthousandthreehundredeightyone -- links -> fortyseventhousandfourhundredtwentytwo;
twelvethousandonehundredninetyfive -- links -> eleventhousandsevenhundredtwentytwo;
sixthousandonehundredthirtyfour -- links -> fifteenthousandtwohundredfortytwo;
twentythreethousandtwohundredthirtynine -- links -> twentythreethousandthreehundredeightyone;
onethousandsixhundredfortyone -- links -> fortythousandeighthundredtwentyone;
twentyfourthousandsevenhundredfive -- links -> fivethousandthreehundredsixtyseven;
twentyfourthousandtwohundredtwenty -- links -> twelvethousandeighthundredsix;
twentyfourthousandsevenhundredfortyfour -- links -> fortysixthousandthreehundrednine;
thirtyeightthousandonehundredthirtytwo -- links -> twentyeightthousandthreehundredtwentyfour;
sixteenthousandthreehundredfortyfour -- links -> thirtyseventhousandonehundredfiftyfive;
threethousandninetythree -- links -> fifteenthousandthreehundredforty;
twentysixthousandthreehundredseven -- links -> sixteenthousandninehundredthirtyfour;
onethousandninehundredthirtyfive -- links -> fortyfivethousandsixhundredsixtyfive;
thirtytwothousandtwohundredten -- links -> twentythreethousandonehundredseventyfive;
eighteenthousandfourhundredseventytwo -- links -> seventhousandonehundredeightytwo;
twentysixthousandninehundredninetyseven -- links -> twentyonethousandsixhundredeightyfour;
twentyeightthousandsevenhundredeightyseven -- links -> fortyfivethousandsixhundredseventyone;
thirtyfourthousandthirtyone -- links -> twelvethousandfourhundred;
twentyseventhousandsixhundredseventyfive -- links -> fortyonethousandfourhundredthirtyeight;
thirtyfourthousandeighthundredseven -- links -> thirtythreethousandnineteen;
twentythreethousandfivehundredfifty -- links -> thirtyfivethousandninehundredtwentyone;
tenthousandfortyfour -- links -> twelvethousandfourhundredtwelve;
fortyninethousandsevenhundredthirtysix -- links -> nineteenthousandsevenhundredseventysix;
thirtyninethousandsevenhundredfiftythree -- links -> twentyfivethousandfourhundredeighteen;
thirtysixthousandtwohundredeightytwo -- links -> fivethousandonehundredthirtytwo;
fortyfivethousandeightynine -- links -> ten;
fortytwothousandseventyone -- links -> twentyonethousandeighthundrednineteen;
eleventhousandfourhundredfortyseven -- links -> twentythreethousandeighthundredeleven;
tenthousandfourhundredninetyone -- links -> fourthousandsixhundredeightyone;
sixteenthousandtwohundredthirtysix -- links -> thirtyonethousandeighthundredtwentyone;
sixthousandsixhundredsixteen -- links -> sixthousandonehundredeightyfour;
twentytwothousandninehundredsixtyfive -- links -> fortyseventhousandfivehundredtwelve;
fortytwothousandsevenhundredsixtyseven -- links -> twentysixthousandfivehundredtwenty;
sixteenthousandseventythree -- links -> thirtyfivethousandsevenhundredtwentyone;
thirtyfivethousandsixhundredeightyseven -- links -> ninethousandfortyone;
sevenhundredforty -- links -> seventeenthousandninehundredeightythree;
thirtyfourthousandsevenhundredone -- links -> fortysixthousandfortyfive;
fourteenthousandeighthundredfiftynine -- links -> thirtyfivethousandthreehundred;
fortyfourthousandsixhundredseventeen -- links -> fortyfivethousandeighthundredseventyfive;
fourthousandthreehundredthirtythree -- links -> fortyfivethousandfivehundredsixtyseven;
thirtythreethousandsevenhundredsixtyeight -- links -> twentyeightthousandonehundredtwentysix;
fortyeightthousandtwohundredfortyone -- links -> thirtythousandsevenhundredfortytwo;
thirteenthousandtwohundredseventyfive -- links -> thirtytwothousandsixhundredsixtyeight;
thirtytwothousandonehundredfortysix -- links -> twothousandfivehundredtwentyeight;
ninethousandsixtyeight -- links -> onethousandfourhundredninety;
thirtyonethousandthreehundred -- links -> thirtythousandeightynine;
fifteenthousandfourhundredninetysix -- links -> thirtyseventhousandsevenhundredfiftyseven;
fortyeightthousandeighthundredthirtythree -- links -> twothousandthreehundredninetynine;
seventeenthousandtwohundredseventyseven -- links -> twentyfivethousandsevenhundredfortyseven;
thirtysixthousandsevenhundredfiftyseven -- links -> thirtyfivethousandonehundredthirteen;
seventeenthousandsevenhundredseventyseven -- links -> thirtyseventhousandtwohundredeight;
thirtyseventhousandsevenhundredfourteen -- links -> thirteenthousandsixhundredthirtynine;
tenthousandfivehundredeight -- links -> fortyonethousandeighthundredfiftytwo;
fortyeightthousandthreehundredfiftythree -- links -> eleventhousandsevenhundredsixtyfour;
thirtyseventhousandfourhundredtwelve -- links -> fortyfourthousandtwohundredtwentysix;
twentyninethousandsixhundredsix -- links -> eightthousandonehundredeightyfour;
onethousandfivehundredseventyone -- links -> thirtytwothousandseventysix;
fourthousandsevenhundredtwo -- links -> thirtyeightthousandsixhundredeightytwo;
twentythousandfourhundredtwentythree -- links -> fortyfivethousandsevenhundredsixtytwo;
fourthousandsevenhundredtwentyeight -- links -> seventhousandninehundredfiftyfive;
seventeenthousandthreehundredthirtythree -- links -> thirteenthousandninehundredtwentyone;
thirtyseventhousandeighthundredfive -- links -> thirtyfourthousandtwohundredfiftythree;
twentyseventhousandtwohundredninetyone -- links -> twentyfivethousandseventytwo;
twentysixthousandeighthundredsixtyone -- links -> fortytwothousandonehundredthirtynine;
twothousandeighthundredsixtyfive -- links -> fortythreethousandeighthundredsixtynine;
sixthousandonehundredsixtyseven -- links -> twentyninethousandfourhundredseventyfour;
thirtyseventhousandfourhundredeightythree -- links -> seventeenthousandfourhundredfourteen;
ninethousandsevenhundredfortynine -- links -> twentyfivethousandfivehundredeightynine;
fortysixthousandninehundredseventyfour -- links -> fifteenthousandsevenhundred;
twentyninethousandeighthundredfiftyeight -- links -> twentyfourthousandeighthundredthirty;
eighteenthousandfivehundredeightyeight -- links -> thirtyfourthousandeighthundredfifty;
fortyninethousandfivehundredninetythree -- links -> twentyseventhousandsixhundredforty;
nineteenthousandonehundredeighteen -- links -> twentyseventhousandninetynine;
twentyonethousandonehundredthirtyone -- links -> fortytwothousandtwohundredeightytwo;
thirtythreethousandfivehundredsixtyfive -- links -> fifteenthousandtwohundredninetyseven;
thirtyonethousandninehundredseventeen -- links -> seventhousandonehundredeighteen;
thirtytwothousandfivehundredforty -- links -> ninethousandfivehundredthirty;
fourthousandfortythree -- links -> twentytwothousandonehundredeleven;
fortyninethousandsevenhundredeighteen -- links -> fifteenthousandninehundredeightynine;
fourteenthousandninehundredfiftyseven -- links -> fourteenthousandninetysix;
onethousandonehundredfiftytwo -- links -> sixteenthousandsevenhundredfortyseven;
thirteenthousandsevenhundredfortynine -- links -> twentyeightthousandtwohundredsixtysix;
fortyseventhousandtwohundredseventyfour -- links -> thirtythousandsevenhundredtwenty;
twentyonethousandonehundredfiftythree -- links -> fortyseventhousandsixhundredfortysix;
sixthousandthreehundredninetyone -- links -> fortythousandfivehundredeightyfour;
seventeenthousandeighthundredeleven -- links -> fortysixthousandthreehundredninetytwo;
seventeenthousandseventyeight -- links -> seventeenthousandfivehundredtwentysix;
thirteenthousandninetyeight -- links -> nineteenthousandfivehundredforty;
thirteenthousandsevenhundrednine -- links -> twentyeightthousandfivehundredfortyfour;
twelvethousandninehundredtwentyfive -- links -> eighteenthousandthreehundredthirty;
thirtythreethousandfourhundrednine -- links -> fourteenthousandfivehundredfiftyeight;
eighteenthousandeighthundredfour -- links -> fortysixthousandsixhundredseventyseven;
sixteenthousandtwohundredseventyseven -- links -> twentyeightthousandninetyseven;
seventhousandseventyfive -- links -> thirtyfourthousandsevenhundredfiftyfour;
thirtyeightthousandtwelve -- links -> sixteenthousandthreehundredeightyfive;
fortyonethousandfortyfour -- links -> fortyonethousandsixhundredfiftytwo;
fortythreethousandsixtyeight -- links -> twentyfivethousandsevenhundredfortythree;
thirtyfourthousandtwohundredeightyeight -- links -> fivethousandsevenhundredsixteen;
fortytwothousandfourhundredseventeen -- links -> twentysixthousandeightynine;
nineteenthousandtwohundredseventythree -- links -> twentyfivethousandeighthundredninetythree;
thirtysixthousandeighthundredninetyone -- links -> fortyonethousandfivehundredsixteen;
twentyfourthousandtwohundredseventynine -- links -> fourthousandsixhundredsixtytwo;
twentysixthousandsevenhundredfortytwo -- links -> fortythreethousandsevenhundredfortyseven;
ninethousandeighthundredfiftythree -- links -> thirtyfivethousandtwentyfour;
twentyonethousandtwohundredfour -- links -> thirtyonethousandninehundredthirtythree;
twentysixthousandninehundredfiftyone -- links -> seventhousandsixhundredseventynine;
fortyninethousandonehundredninetythree -- links -> ninethousandfivehundredeightyone;
fifteenthousandsevenhundredsixtythree -- links -> fortyninethousandninehundredeightytwo;
eightthousandsixhundredninety -- links -> fourthousandthreehundredseventynine;
threethousandfivehundredninetythree -- links -> tenthousandfivehundredseventyone;
onethousandtwohundredsixtysix -- links -> nineteenthousandeighthundredthirtytwo;
fortythreethousandfivehundredfortyfour -- links -> thirteenthousandone;
twentysixthousandfivehundredseventyone -- links -> thirtyseventhousandthreehundredseventyfour;
fifteenthousandsevenhundredfiftyeight -- links -> twentyfivethousandfourhundredtwelve;
twentyseventhousandfourhundredtwentynine -- links -> fortythreethousandninetyfour;
fourthousandeighthundredfiftyone -- links -> eleventhousandsixhundredsixteen;
tenthousandfivehundredeleven -- links -> ninethousandeighthundredtwentyseven;
fivethousandninehundredtwentythree -- links -> twentyninethousandninehundredfourteen;
threethousandfivehundredthree -- links -> sixthousandeighthundredseventysix;
sevenhundredtwentysix -- links -> thirtyseventhousandsixhundredthirtytwo;
ninethousandsevenhundredninetynine -- links -> thirtysixthousandfourhundredtwentyfour;
twentytwothousandsevenhundredeighteen -- links -> twentythreethousandeightyfour;
twelvethousandsevenhundredfortythree -- links -> twothousandeighthundredthirtythree;
fortyeightthousandthreehundredsixtyfour -- links -> fortythreethousandeightythree;
thirtyfourthousandninehundredsixtyeight -- links -> fifteenthousandeightytwo;
seventeenthousandthreehundredtwelve -- links -> thirtyonethousandninehundredsixtyfive;
nineteenthousandfivehundredthirtytwo -- links -> twentysixthousandthreehundredninetyseven;
thirtyninethousandsixhundredfiftynine -- links -> fortyfivethousandsixtyone;
sixteenthousandthreehundredthirtysix -- links -> thirtythousandsixhundredtwentyone;
twentysixthousandthreehundredseventy -- links -> fourteenthousandninehundredfiftynine;
seventeenthousandsevenhundredthirtyeight -- links -> eightthousandtwohundredfifty;
threethousandonehundredtwentytwo -- links -> twentyfivethousandsevenhundredtwentynine;
thirtyeightthousandeighthundredeightyfive -- links -> twentyninethousandninehundredseven;
fivethousandninehundredfourteen -- links -> fortytwothousandthreehundredsixtytwo;
twelvethousandfourhundredsix -- links -> twentythreethousandonehundredfiftyeight;
fourteenthousandeighthundredeightynine -- links -> fortytwothousandfivehundredthirtysix;
twentythousandthreehundredfortyseven -- links -> twentyninethousandsixhundredsixtyseven;
fortyseventhousandonehundredeightynine -- links -> eleventhousandsixhundredseventy;
thirtyeightthousandsevenhundredninetynine -- links -> seventeenthousandsixhundredsixtythree;
thirtythreethousandninehundredeightynine -- links -> twentyeightthousandfivehundredseventyseven;
thirtyninethousandtwohundredninetytwo -- links -> thirtyfourthousandthreehundredthirtynine;
thirtytwothousandeighthundredtwentyeight -- links -> thirtyfivethousandonehundredsixteen;
twelvethousandfivehundredseventythree -- links -> thirtysixthousandsevenhundredtwentyfour;
fortyfivethousandfiftyeight -- links -> nineteenthousandninehundredsixtytwo;
twentythreethousandfiftyfive -- links -> twentythreethousandeighthundredfiftyfour;
eighteenthousandeightyone -- links -> thirtysixthousandtwohundredninetysix;
twentyfourthousandninehundredninetysix -- links -> thirteenthousandonehundredsixtytwo;
twentyeightthousandfiftyseven -- links -> thirteenthousandtwentyone;
fivethousandfivehundredseventyone -- links -> eighteenthousandninehundredninetyone;
seventhousandeighthundredtwentyfour -- links -> eighteenthousandthreehundredthirteen;
fourteenthousandfivehundredtwentyseven -- links -> twentyeightthousandonehundred;
twentytwothousandonehundredtwentytwo -- links -> thirtytwothousandninehundredtwentythree;
thirtyeightthousandninehundredfortysix -- links -> fivethousandsevenhundredeighty;
twelvethousandthreehundredsixtyeight -- links -> nineteenthousandfivehundredthree;
thirtyeightthousandeighthundredtwentytwo -- links -> thirtyeightthousandtwohundredninetyeight;
fivethousandfivehundredsixtyeight -- links -> twentythousandonehundredsixtyfour;
tenthousandninetyseven -- links -> fortythreethousandtwohundredseventyfive;
thirtythreethousandninehundredeightyfive -- links -> thirtyeightthousandonehundredtwentyfour;
fivethousandeighthundredsixtysix -- links -> thirtyeightthousandsixtyseven;
thirtyeightthousandsixhundredfiftyeight -- links -> thirtythousandthreehundred;
twentyseventhousandfourhundredtwenty -- links -> twentythousandtwohundredfortyseven;
fortyeightthousandthreehundredsixtysix -- links -> twentyninethousandfortythree;
twentyfivethousandsevenhundredeighteen -- links -> thirtythreethousandfivehundredninetyfour;
thirtyfivethousandthreehundredfortyone -- links -> seventhousandeighthundredninetysix;
twentyfivethousandninehundredninetysix -- links -> fortyonethousandnineteen;
fortyonethousandfourhundredeighteen -- links -> twelvethousandninehundredtwentyfour;
ninehundredseventyfour -- links -> thirtytwothousandeighthundredninetyone;
sixteenthousandfourhundredtwelve -- links -> twentythousandfivehundredten;
fourthousandthreehundredtwentytwo -- links -> fortythreethousandsevenhundredseventythree;
thirtyseventhousandsixhundredfour -- links -> thirteenthousandsixhundredtwentynine;
fortythousandninehundredtwentyeight -- links -> eightthousandeighthundredfiftyfour;
twentytwothousandninehundredsixtytwo -- links -> fortythreethousandtwohundredseventytwo;
onehundredseven -- links -> thirtyfourthousandfivehundredfortyeight;
twothousandfourhundredeightyfour -- links -> twentysixthousandfivehundredtwentynine;
tenthousandeighthundredtwentythree -- links -> onehundredeightyseven;
fortyseventhousandninehundredeightyone -- links -> twentysixthousandeighthundredfortynine;
fortyeightthousandonehundredseventyone -- links -> thirtysixthousandfourhundredfortytwo;
thirtythreethousandeighthundredfiftythree -- links -> twentyninethousandthreehundredeightyone;
fortysixthousandtwohundredseventyseven -- links -> fortytwothousandninehundredtwentyfive;
twentythreethousandtwohundredtwo -- links -> seventhousandtwohundredtwentyone;
sixthousandsevenhundredforty -- links -> thirtyseventhousandthreehundredtwentythree;
twentyninethousandthreehundredthirtynine -- links -> fortyeightthousandsixhundredsixtyone;
thirtyfourthousandthirtyeight -- links -> thirtyonethousandsevenhundredtwentyseven;
twentyninethousandfourhundredthirteen -- links -> fortyninethousandfivehundredfiftyseven;
twentyseventhousandthreehundredfortytwo -- links -> twothousandsevenhundredforty;
twentyseventhousandthreehundredsixtyfour -- links -> seventeenthousandeighthundredfortythree;
fifteenthousandthreehundredtwentynine -- links -> sixteenthousandeighthundredtwentyfive;
twentyonethousandthreehundredfortyfour -- links -> fortysixthousandfourhundred;
thirtyeightthousandsixhundredtwentytwo -- links -> twentythousandninehundredninetysix;
tenthousandfiftyseven -- links -> twentyseventhousandthreehundredfortyfour;
twentythousandfivehundredthree -- links -> twentysixthousandsevenhundredthirtynine;
tenthousandfourhundredforty -- links -> twelvethousandfourhundredfortythree;
sixthousandsevenhundredtwentyone -- links -> seventeenthousandninehundredfortynine;
fourteenthousandonehundredfifteen -- links -> eleventhousandnine;
thirtyfourthousandninehundredninetysix -- links -> nineteenthousandthreehundredsixtyseven;
fourthousandsixhundredeightyfive -- links -> nineteenthousandonehundredfortysix;
sixhundredeightyseven -- links -> fortyseventhousandsevenhundredthirtyone;
twentytwothousandonehundredeightyfour -- links -> sixthousandfivehundredeightysix;
thirtyeightthousandtwohundredsixtyseven -- links -> fourteenthousandfourhundredfiftyone;
nineteenthousandsixhundredfiftyfive -- links -> sixteenthousandeightyfour;
thirtythousandeighthundredfiftyeight -- links -> twentyseventhousandfourhundredninetynine;
twentyninethousandonehundredfortyone -- links -> fortythreethousandthreehundredfifty;
nineteenthousandfourhundredtwenty -- links -> thirtyeightthousandfourhundredfour;
seventeenthousandthreehundredforty -- links -> tenthousandtwohundredninety;
thirtysixthousandsixhundredeightysix -- links -> thirtyseventhousandthreehundredfiftyseven;
thirtyeightthousandonehundredseventynine -- links -> sixthousandeighthundredtwelve;
fourthousandonehundredfortythree -- links -> seventeenthousandfourhundredfiftytwo;
fortythousandsevenhundredtwentyseven -- links -> thirtyseventhousandthreehundredninetyone;
nineteenthousandfourhundredeightyeight -- links -> nineteenthousandfivehundredfiftyfive;
thirtythousandtwenty -- links -> thirtyeightthousandonehundredtwentythree;
eleventhousandtwohundredeightyeight -- links -> fortyeightthousandfivehundrednine;
fortyonethousandtwohundredninetysix -- links -> twentythousandninehundredfive;
twentyseventhousandeighthundredfiftyseven -- links -> fortyfivethousandsixhundredseventyone;
twentyfivethousandfourhundredtwelve -- links -> sixhundredthirtynine;
twentyeightthousandfivehundredsixtythree -- links -> thirtyonethousandninehundredninetyfive;
twentythreethousandthreehundredeightyfour -- links -> fortythousandthreehundredthirtyfour;
seventeenthousandninetyeight -- links -> twentyonethousand;
eleventhousandfourhundredeighteen -- links -> seventeenthousandsevenhundredfiftytwo;
thirteenthousandsevenhundredeightytwo -- links -> twothousandeighthundredninetyfour;
onethousandtwohundredfortythree -- links -> twothousandfourhundred;
thirtyfivethousandfourhundredfiftyfive -- links -> twentyeightthousandeighthundredfive;
sixthousandsevenhundredfiftyeight -- links -> twentytwothousandninety;
thirtyonethousandsixhundredthirtyfive -- links -> fourthousandfortyfive;
thirtyninethousandfivehundredthirtythree -- links -> fivethousandfivehundredtwentyone;
thirtyfourthousandninehundredtwentysix -- links -> sixthousandonehundredeleven;
twentyeightthousandfivehundredninetyfour -- links -> fourthousandninehundredthirtyfive;
fivethousandsixhundredsixtynine -- links -> fifteenthousandeighthundredfortythree;
onethousandeighthundredseventytwo -- links -> twentyseventhousandonehundredninetyone;
sixthousandfivehundredseventyfive -- links -> sixteenthousandfivehundredtwentythree;
fortyfivethousandfourhundredfiftynine -- links -> seventhousandfivehundredseventyfour;
fourthousandfivehundredfortyfour -- links -> thirtysixthousandthreehundredseventeen;
thirtyfourthousandninehundredtwentytwo -- links -> fortytwothousandeighthundredeight;
thirtyninethousandninehundredseventyone -- links -> tenthousandeighthundredthirty;
nineteenthousandeighthundredseventynine -- links -> eighteenthousandsixhundredseventyone;
twothousandfivehundredfortyseven -- links -> sixteenthousandonehundredfive;
onethousandfourhundredfortyone -- links -> twentyninethousandtwohundredfifteen;
fortyeightthousandthreehundredninety -- links -> threethousandsixhundredthirty;
fortysixthousandsevenhundredeleven -- links -> twentyninethousandthreehundredfiftysix;
fortyseventhousandsevenhundredsixtysix -- links -> twentyninethousandsixhundredforty;
twentytwothousandeighthundredfortyeight -- links -> fortyninethousandninehundredeightynine;
thirtythreethousandsevenhundredninety -- links -> eighteenthousandthreehundredfortythree;
fifteenthousandonehundredfiftyfive -- links -> twentythousandeighthundredfiftyeight;
twelvethousandthreehundredfifty -- links -> fifteenthousandsixhundredninetytwo;
thirtyonethousandeighthundredseventytwo -- links -> twentyninethousandonehundredfortythree;
twentythousandfourhundredfortythree -- links -> thirtythreethousandsixhundrednineteen;
twentyeightthousandsixhundredthirtyfour -- links -> twentysixthousandonehundredthirtythree;
twothousandseventy -- links -> thirtyfivethousandsevenhundredsix;
twentyninethousandfourhundredseventyfour -- links -> twentytwothousandfivehundredninetyeight;
twentytwothousandtwohundredfifteen -- links -> fifteenthousandonehundredeightyfour;
fortythousandonehundredsixtyone -- links -> thirteenthousandtwohundredfortyseven;
twentytwothousandsixhundredsixtytwo -- links -> twentythousandonehundredthirtyseven;
twentythousandfourhundredfortynine -- links -> sixteenthousandfivehundredsixtytwo;
fortythreethousandeighthundredthirteen -- links -> eighteenthousandfourteen;
sixhundredninetyseven -- links -> fifteenthousandninehundredseventysix;
eleventhousandfive -- links -> seventeen;
fourteenthousandfivehundredninetyfive -- links -> twentythousandsixhundredseventy;
sixthousandeighthundredfour -- links -> twentysixthousandthreehundredeighteen;
onethousandonehundredthirtyone -- links -> fifteenthousandeighthundredseventynine;
twentysixthousandonehundredfour -- links -> twentyninethousandninehundredninetysix;
twentyseventhousandsevenhundredsixtysix -- links -> thirtythreethousandtwohundredfifteen;
fortythreethousandsevenhundredseventyone -- links -> eightthousandthreehundredseven;
twentythousandonehundredfiftyseven -- links -> twentyseventhousandthreehundredninetyone;
fortytwothousandsevenhundredninetyfive -- links -> eleventhousandeighty;
fiftytwo -- links -> twentyonethousandfiftytwo;
seventhousandthreehundredforty -- links -> twothousandninehundredfortyeight;
eighteenthousandsevenhundredfifteen -- links -> fifteenthousandsevenhundredeightysix;
tenthousandthreehundredfiftysix -- links -> fourteenthousandninehundredninetyfive;
twentyseventhousandsevenhundredsixtyone -- links -> twentyonethousandfourhundredsix;
eightthousandsevenhundredtwentytwo -- links -> ninethousandfivehundredfortyfour;
fortyeightthousandfivehundredsixty -- links -> thirtysixthousandtwohundredfiftyeight;
fortyseventhousandfourhundredfiftytwo -- links -> fortyseventhousandfivehundredsixtyfive;
thirtyeightthousandsevenhundredseventyseven -- links -> twentythreethousandseventythree;
twentyfivethousandfourhundredfortyfour -- links -> thirtythousandsixhundredfortyseven;
thirteenthousandsixhundredthirteen -- links -> seventhousandninehundredfiftyfour;
thirteenthousandsevenhundrednineteen -- links -> twentyfivethousandthreehundredeightyfive;
twentyseventhousandfivehundrednine -- links -> seventeenthousandeighthundredtwentyfive;
eighteenthousandtwohundredten -- links -> twentytwothousandtwohundredfiftyfive;
fortyseventhousandsevenhundredfortytwo -- links -> onethousandsixhundredforty;
fivethousandthreehundredtwentynine -- links -> twelvethousandonehundredseven;
threehundredfiftysix -- links -> thirtyninethousandsixhundredthirty;
fortytwothousandeighthundredeightyfive -- links -> thirtyseventhousandeighthundredtwentyone;
fortythreethousandfifty -- links -> fortyeightthousandfourhundredseventy;
sixteenthousandfourhundredninetysix -- links -> twentyeightthousandtwohundredtwo;
fourthousandonehundredsixtyfour -- links -> thirtyeightthousandeight;
thirtytwothousandeighthundredthirtytwo -- links -> fourteenthousandsevenhundredthree;
twentyninethousandonehundredsixtynine -- links -> thirtysixthousandsixhundredsixtyeight;
thirtythreethousandsevenhundredninetyeight -- links -> fortyeightthousandeighthundredfifteen;
fortytwothousandtwohundredsixtyfour -- links -> thirtysixthousandonehundredthirty;
thirtythousandthreehundredseventyone -- links -> seventeenthousandsevenhundredfour;
fortyninethousandsixhundredsixtyone -- links -> fortyonethousandfivehundredthirtyfive;
nineteenthousandsevenhundredtwentysix -- links -> twentythousandonehundred;
thirtyfivethousandninehundredeightyfour -- links -> thirtyeightthousandtwo;
twentythreethousandthreehundredeighty -- links -> seventeenthousandfourhundredsixtyeight;
eightthousandninehundredseventynine -- links -> twentysixthousandthreehundredtwentyfive;
fortyseventhousandtwohundredseventysix -- links -> thirtyonethousandsixhundredsix;
fortythousandonehundredfifty -- links -> twentyfourthousandeighthundredfortyseven;
thirtytwothousandonehundredeighteen -- links -> fourteenthousandsixhundredseventyone;
fortyfourthousandfivehundredfortyfive -- links -> fortyfourthousandonehundredtwo;
fifteenthousandfivehundredthree -- links -> ninehundredseventynine;
fortyfourthousandsevenhundredsixtyfive -- links -> thirtyseventhousandfourhundredfortytwo;
twentyfourthousandeighthundrednineteen -- links -> fivehundredtwentyone;
thirtyfivethousandseventyone -- links -> fivethousandsevenhundredtwentyfour;
onehundredseventysix -- links -> fivethousandsixhundredtwentyeight;
twothousandsixhundredten -- links -> fifteenthousandonehundredfiftyseven;
eightthousandtwohundredfiftynine -- links -> fortyseventhousandonehundredfiftysix;
fortyfivethousandonehundredsixtyeight -- links -> thirtysixthousandtwohundredtwentyseven;
nineteenthousandtwohundredninetyeight -- links -> thirtyfourthousandsixhundredtwentyeight;
sixteenthousandfivehundredfortyone -- links -> thirtysixthousandonehundredeightytwo;
fifteenthousandsixtyone -- links -> thirtyfivethousandeighthundredthirtysix;
thirtyfivethousandonehundredthirtysix -- links -> seventeenthousandninehundredtwentynine;
fortyseventhousandninehundredthirtyeight -- links -> fortysixthousandtwohundredseventy;
thirtythreethousandsevenhundredfiftyeight -- links -> twentyfourthousandsevenhundredeight;
thirtythousandfivehundredseventynine -- links -> thirtythousandeighthundredseventyseven;
twentyeightthousandeighthundredeightyfive -- links -> fortyfourthousandthreehundredsixtysix;
thirteenthousandonehundredfiftyseven -- links -> thirtysixthousandeighthundredeightytwo;
fortyseventhousandonehundredthirtyeight -- links -> fifteenthousandeight;
thirtythreethousandthreehundredninetytwo -- links -> twentyninethousandtwohundredfortyone;
sixthousandthreehundredeightythree -- links -> twentyfivethousandninehundrednine;
tenthousandonehundredtwentysix -- links -> twentyninethousandsixteen;
fortyseventhousandthreehundredforty -- links -> fivethousandfourhundredfiftythree;
eighteenthousandfortytwo -- links -> eightthousandninehundredtwentyseven;
twentythousandtwohundredthirtythree -- links -> fortytwothousandonehundredthirteen;
fortytwothousandeighthundredthirtynine -- links -> fortyfivethousandeighthundredeighteen;
thirtyfourthousandsevenhundredeightytwo -- links -> twentyeightthousandninehundredseventyseven;
twentythreethousandsevenhundredtwentytwo -- links -> fourteenthousandfivehundredsixteen;
sixthousandeighthundredseventytwo -- links -> threethousandthirtytwo;
onethousandeighthundredseventysix -- links -> twentyninethousandfortysix;
thirtytwothousandeighthundredsixteen -- links -> thirtythousandfourhundredsixtyfive;
thirtyonethousandonehundredeightyfour -- links -> eighthundredfortyfive;
fortyfivethousandfourhundredsixteen -- links -> fortythreethousandninehundredseven;
thirteenthousandthreehundredsixtysix -- links -> sixteenthousandfiftyeight;
fortythousandeighthundredsixtynine -- links -> thirtyninethousandtwohundredforty;
thirtytwothousandthreehundredthirteen -- links -> fourthousandfourhundredfifty;
eleventhousandtwelve -- links -> nineteenthousandfourhundredfiftyone;
twentythreethousandninehundredseventyone -- links -> twentythousandtwohundredsixtytwo;
twentyfivethousandfivehundredsixtythree -- links -> tenthousandtwohundredfiftysix;
twentysixthousandsixhundrednineteen -- links -> twentyninethousandsevenhundredseventythree;
twentythreethousandsixhundredninetythree -- links -> fourthousandtwohundredsixtynine;
twentyninethousandfivehundredfour -- links -> ninethousandthreehundrednine;
eighteenthousandfourhundredfiftysix -- links -> twothousandninehundredthirtyfour;
eighteenthousandsevenhundredtwentyfive -- links -> thirtyonethousandsevenhundredeightyfour;
twentyninethousandeightyseven -- links -> thirtyninethousandsixhundredseventyone;
thirtythreethousandonehundredsixtyone -- links -> eighthundredthree;
thirtytwothousandtwohundredseventyone -- links -> threethousandthreehundredeightysix;
fortytwothousandtwohundredninety -- links -> thirtyseventhousandtwohundredsixtysix;
fifteenthousandeighthundredeightynine -- links -> fortyseventhousandtwohundredeight;
nineteenthousandthreehundredsixtyfive -- links -> eightthousandfourhundredfortyseven;
thirtyfivethousandeighthundredeightythree -- links -> twentysixthousandninetytwo;
fortyfourthousandeighthundredfiftytwo -- links -> thirtyfourthousandeighthundredtwentysix;
twentysixthousandninehundredfortyseven -- links -> fortyfourthousandtwohundredfortythree;
tenthousandthreehundredeightyeight -- links -> sixthousandfivehundredseventy;
fortytwothousandninehundredtwentynine -- links -> seventeenthousandfourhundredforty;
twentyfivethousandsevenhundredthirtyeight -- links -> fifteenthousandsixhundredthirtyfour;
seventeenthousandsixhundredseventynine -- links -> thirtytwothousandsixty;
thirtyfourthousandonehundredseventyeight -- links -> thirtyfivethousandfourhundredthirtyeight;
fourthousandonehundredninetytwo -- links -> thirtyseventhousandtwohundredten;
nineteenthousandthreehundredfiftysix -- links -> ninethousandsixhundredsixty;
twentyfivethousandninehundredfourteen -- links -> eightthousandeighthundrednine;
twentyfivethousandeighthundredseventyfive -- links -> eighthundredtwentyfour;
fortyonethousandfourhundredfiftyseven -- links -> thirtyeightthousandsevenhundredthirtyeight;
thirtyseventhousandnineteen -- links -> ninethousandtwohundred;
thirtyninethousandfivehundredthirtyseven -- links -> twothousandonehundredthirteen;
fortytwothousandninehundredthirtyfive -- links -> fifteenthousandonehundredseventyfour;
fortyfourthousandeighthundredseventytwo -- links -> thirtyonethousandeightynine;
thirteenthousandninehundredforty -- links -> eleventhousandninetytwo;
fortyonethousandsixhundredninetyfour -- links -> thirtyfourthousandfivehundredsixty;
thirtyninethousandfourhundredninetythree -- links -> twentythousandtwohundredthirtythree;
thirtythousandsixhundredninetyone -- links -> fortyseventhousandeighthundredseventyfour;
twentythreethousandsevenhundredfiftyfive -- links -> ninethousandninehundredfiftyfour;
fortysixthousandeighthundredsixtyseven -- links -> fortyeightthousandsixhundredeightynine;
seventeenthousandonehundredfiftythree -- links -> fourteenthousandtwohundredseventysix;
fortyseventhousandfourhundredninetysix -- links -> fortyeightthousandsevenhundredfiftythree;
fourthousandtwohundredtwentysix -- links -> fortyeightthousandsevenhundredseventythree;
twelvethousandonehundredforty -- links -> twentythousandfivehundredseventyeight;
twentyeightthousandonehundredthirtyfive -- links -> fortyfivethousandsixhundredfortytwo;
thirteenthousandninehundredfortyfour -- links -> fortyninethousandthreehundredseventyfive;
fourteenthousandsevenhundredthirtyseven -- links -> onethousandfourhundredninetynine;
seventeenthousandtwohundredninetyfour -- links -> fortyeightthousandthirtyfive;
twentyninethousandeighthundredseven -- links -> fortysixthousandthreehundredseven;
fortytwothousandsevenhundredthirtysix -- links -> fifteenthousandsevenhundredseven;
twelvethousandsevenhundredone -- links -> seventeenthousandeighthundredninetytwo;
thirtyninethousandthreehundredtwentyfour -- links -> fortytwothousandeighthundredseventy;
twentythreethousandonehundredseventyseven -- links -> onethousandfivehundredeleven;
eightthousandninehundredseventeen -- links -> fortysixthousandonehundredsixtynine;
twothousandtwohundredeleven -- links -> thirtyninethousandsixhundredsixtyfive;
fortyninethousandsixhundredfortysix -- links -> twentyfourthousandfourhundredsixtyfour;
thirtyfourthousandfourhundredthirtytwo -- links -> fortysixthousandthirtythree;
fivethousandonehundredfortyone -- links -> thirtythreethousandfivehundredeightythree;
thirteenthousandsevenhundredtwentythree -- links -> twentythousandninehundredthirtythree;
fortyninethousandtwohundredfortyone -- links -> fortyfivethousandthreehundredfifty;
thirtysixthousandeighthundredfortyone -- links -> twentysixthousandeighthundredtwentyeight;
fivethousandninehundredninetyfour -- links -> sixteenthousandfourhundredthree;
thirtyonethousandeighthundredninetyfive -- links -> thirtyonethousandeighthundredsixtythree;
fortytwothousandsixhundredfour -- links -> twentythreethousandfivehundredfive;
twelvethousandtwohundredseventyfour -- links -> seventhousandsixhundredtwentyfive;
fourteenthousandfivehundredninetynine -- links -> fortyninethousandninehundredfifty;
onethousandsixhundredthirtyfive -- links -> eightthousandeighthundredseventyeight;
thirtyseventhousandthreehundredfiftyeight -- links -> twentyfivethousandfourhundredninetyeight;
twentythreethousandfourhundredfortyfive -- links -> fortyfivethousandninehundredseventyfive;
thirtyninethousandfourhundredsixtysix -- links -> eightthousandfourhundredninetyone;
fifteenthousandfivehundredtwentyfour -- links -> seventhousandninehundredfiftyfive;
onethousandonehundredthirtynine -- links -> fortytwothousandtwohundredfive;
ninethousandsevenhundredninetysix -- links -> thirtyseventhousandeighthundredeightyone;
thirtythousandeighthundredeleven -- links -> thirtythousandfivehundredeightythree;
seventhousandfourhundredfiftyone -- links -> tenthousandthreehundredsix;
fortyfivethousandonehundredfortytwo -- links -> threethousandninehundredfourteen;
sixthousandeighthundredseventysix -- links -> ninethousandsixhundredninetynine;
twentyninethousandthreehundredtwentyone -- links -> twelvethousandtwohundredninety;
fortyfourthousandeightyone -- links -> fivethousandsevenhundredtwenty;
twentysixthousandsevenhundredsixtysix -- links -> twentytwothousandsixtythree;
twentyseventhousandninehundredeightyeight -- links -> fortythousandonehundrednine;
fortyonethousandsevenhundredseventyseven -- links -> thirtysixthousandthreehundredthirtythree;
twentyfivethousandtwohundredtwentysix -- links -> fortyninethousandfourhundredthirteen;
twentyfivethousandsevenhundredthirtynine -- links -> twentyseventhousandfourhundredeightyseven;
thirtysixthousandninehundredtwentyfive -- links -> twentytwothousandsevenhundredthirtyfour;
twothousandfiftysix -- links -> twentyonethousandtwo;
fourthousandfivehundredsixtyfour -- links -> fortyonethousandninehundredninetysix;
fourteenthousandfivehundredthree -- links -> thirteenthousandsixhundredsixtyone;
twelvethousandtwohundrednine -- links -> thirtyeightthousandeighthundredsixtyfive;
fortyonethousandtwohundredfortyfive -- links -> twelvethousandtwohundredseven;
ninethousandfortysix -- links -> twelvethousandtwohundredeightysix;
thirtyninethousandfivehundredtwentysix -- links -> nineteenthousandninehundredfive;
twentytwothousandeighthundredfive -- links -> fortythousandonehundredsixtythree;
thirtyfourthousandthreehundredfortysix -- links -> seventhousandfourhundredten;
thirtyseventhousandfivehundredseventyone -- links -> tenthousandfourhundredninetyeight;
onethousandfivehundredseventysix -- links -> sixthousandfivehundredfortyfive;
thirteenthousandonehundredtwentyeight -- links -> twentythousandthreehundredtwentytwo;
tenthousandninehundredfourteen -- links -> sixthousandfivehundredfortyone;
fourthousandtwohundredsixtytwo -- links -> seventhousandeightyseven;
ninethousandfourhundredtwelve -- links -> fortyseventhousandeighthundredone;
seventeenthousandfivehundredeight -- links -> fivethousandthreehundredfiftynine;
twentyeightthousandthreehundredtwentytwo -- links -> thirtyfourthousandfourhundredtwentyseven;
eighteenthousandsevenhundredfortytwo -- links -> twentytwothousandninehundredninetytwo;
fortythreethousandtwohundredsixtyone -- links -> twentyseventhousandonehundredtwentythree;
fortytwothousandtwentysix -- links -> twentytwothousandninehundredseventytwo;
fortyseventhousandfivehundredthirtyseven -- links -> sixteenthousandeighthundredseventythree;
twentythreethousandtwohundredeightyone -- links -> thirtyonethousandninehundredeighteen;
onehundredseventyfour -- links -> thirteenthousandonehundredthree;
thirteenthousandtwohundredfiftyfive -- links -> twothousandfourhundredseventynine;
fifteenthousandsevenhundredfortyfive -- links -> fortyeightthousandsixtynine;
onethousandninehundredfiftyfour -- links -> twelvethousandonehundredeightyfive;
fortysixthousandsevenhundredfiftyone -- links -> thirtyninethousandninehundredfortyeight;
thirtythousandthree -- links -> twentyeightthousandninehundredtwentyfive;
twentyfivethousandfivehundredthirtythree -- links -> thirtyninethousandfourhundredninety;
onethousandtwohundredtwentyeight -- links -> fortytwothousandfivehundredfortythree;
sixteenthousandfivehundredeleven -- links -> threethousandsevenhundredtwentyfour;
twentyfourthousandtwohundredtwentythree -- links -> twentyfourthousandsixhundredthirtynine;
twentyfivethousandthreehundredtwentythree -- links -> sixteenthousandfivehundredfortysix;
thirtyseventhousandfivehundredeighteen -- links -> onethousandfiftynine;
sixthousandthreehundredseventyseven -- links -> twelvethousandfourhundredthree;
ninethousandninehundredseventytwo -- links -> thirteenthousandonehundredthirtyfive;
thirtyninethousandsixhundredtwentysix -- links -> twentyfivethousandfivehundredseventyeight;
twelvethousandfivehundredfiftyeight -- links -> fourthousandfourhundredeightyseven;
thirtyfivethousandsixhundredsixtyfive -- links -> fourthousandforty;
twelvethousandthreehundredninetytwo -- links -> thirtyfourthousandtwohundrednineteen;
twothousandtwohundredfiftyeight -- links -> seventeenthousandninehundredeightyfive;
fortythreethousandtwohundred -- links -> twentyninethousandsixhundredfortynine;
tenthousandninehundredninetyeight -- links -> thirtyninethousandonehundredfiftyfive;
thirtyseventhousandtwohundredfiftyseven -- links -> thirteenthousandsevenhundredtwentynine;
twentysixthousandtwohundredninetysix -- links -> thirtyonethousandninehundredthirtysix;
thirtyfourthousandtwohundredthirtynine -- links -> fortyseventhousandonehundredseventyseven;
twentyninethousandthreehundredfortythree -- links -> twentyonethousandeighthundredtwentyone;
sixthousandtwohundredeightynine -- links -> fourteenthousandeighthundredfortynine;
thirtyninethousandsevenhundredfiftythree -- links -> twentytwothousandfivehundredsixtytwo;
thirtytwothousandonehundredninetytwo -- links -> fortyfourthousandthreehundredthirteen;
fortyeightthousandninehundredsixty -- links -> twentyonethousandsixhundredtwo;
ninethousandfivehundredsix -- links -> thirtyfourthousandtwohundredsix;
threethousandtwohundredfortythree -- links -> tenthousandsixtynine;
fivethousandfourhundredfortythree -- links -> thirtythreethousandeighthundredeightythree;
twentythousandfiftytwo -- links -> eleventhousandthreehundredsixtyone;
twentyseventhousandfivehundredninetyfour -- links -> eightthousandfourhundredninetytwo;
threethousandthreehundredninetythree -- links -> twentytwothousandonehundredeightyfour;
thirtyeightthousandsevenhundredfiftyfive -- links -> seventhousandfourhundredseventy;
eighteenthousandfivehundredsixtyone -- links -> fortyeightthousandseventyfour;
ninethousandninehundredeighteen -- links -> threethousandfivehundredeightyseven;
twentyninethousandseventyeight -- links -> tenthousandsixhundredeighteen;
twentyseventhousandfivehundredseventyone -- links -> thirtythreethousandfortyone;
eleventhousandsevenhundredeightyfive -- links -> fortyninethousandonehundredsixtysix;
fortyseventhousandninehundredninetynine -- links -> thirtyfourthousandsixhundredeightytwo;
fourteenthousandfourhundredfourteen -- links -> thirteenthousandfivehundredthirtyseven;
eleventhousandsixhundredninetysix -- links -> eightthousandthreehundredtwentysix;
twentyfivethousandsevenhundredone -- links -> fortytwothousandsixhundredfortythree;
fortythreethousandfivehundredninetyfour -- links -> twentyfivethousandonehundred;
twentyonethousandeighthundredeighteen -- links -> fortyfourthousandfourhundredsixteen;
seventeenthousandfourhundredeleven -- links -> thirtysixthousandeighthundred;
thirtyfivethousandsevenhundredeightysix -- links -> twentysixthousandeighthundredfortyfive;
fivethousandonehundredsixtynine -- links -> fortyonethousandsixhundredsix;
twothousandninehundredsixtytwo -- links -> nineteenthousandsevenhundredfiftyeight;
threehundredsixtysix -- links -> fortyninethousandtwohundredthirtyseven;
twentyfourthousandonehundredthirtythree -- links -> thirtyonethousandsevenhundredfortynine;
sixteenthousandfivehundredseventeen -- links -> eighteenthousandsevenhundredten;
twentythousandeighthundredten -- links -> fortyfivethousandsixtytwo;
twentyseventhousandeightyfour -- links -> thirtyfourthousandseventyfive;
tenthousandfourhundredthirtytwo -- links -> thirtyeightthousandthreehundredten;
thirtythreethousandfourhundredeightyfive -- links -> fortysixthousandonehundredfiftyseven;
fortyseventhousandninehundredeightythree -- links -> fivethousandtwohundredsixtyfive;
twentyfourthousandeightythree -- links -> thirtyfourthousandonehundredtwentysix;
thirtyfourthousandfourhundredthirteen -- links -> twelvethousandtwohundredfifty;
thirtytwothousandtwohundredeightyfive -- links -> fortysixthousandtwohundredseventy;
eleventhousandsevenhundredsixtynine -- links -> twentyonethousandsevenhundredeightynine;
fivethousandfivehundredtwentytwo -- links -> thirtyeightthousandthreehundredfortyfour;
twentysixthousandsevenhundredtwentyseven -- links -> fifteenthousandeighthundredeightynine;
thirtyseventhousandeighthundredten -- links -> seventeenthousandfiftytwo;
twelvethousandthreehundredfortyfive -- links -> fourteenthousandfivehundredeightyfive;
fortytwothousandfourhundredfiftythree -- links -> thirtyfivethousandeighthundredthirtytwo;
thirtyseventhousandeighthundredthirty -- links -> twentytwothousandfivehundredeightyfive;
thirtythreethousandfourhundredseventyfour -- links -> twentyninethousandninehundredthirtyfive;
fortyonethousandthreehundredeightyfive -- links -> thirtysixthousandfivehundredtwo;
fivethousandseventy -- links -> eleventhousandfourhundredthirtysix;
thirtyseventhousandsixhundredeightynine -- links -> nineteenthousandsevenhundredninetyeight;
thirtyseventhousandsixhundredsixtythree -- links -> thirtyfivethousandfourhundredeightyseven;
fortyeightthousandninehundredtwentyeight -- links -> thirtythreethousandfourhundredsixtythree;
eightthousandthreehundredsixtythree -- links -> twentyonethousandtwohundredeightyfive;
twentysixthousandseventyfive -- links -> twentyninethousandninehundredthirtyone;
fortythousandonehundredfourteen -- links -> twentyninethousandfortyseven;
eleventhousandfive -- links -> ninehundredninetythree;
sixteenthousandonehundredthirtythree -- links -> thirtyseventhousandone;
nineteenthousandfourhundredeight -- links -> twentyseventhousandfourhundredseven;
thirtyfourthousandfivehundredfortyfive -- links -> threehundredthirtynine;
twentythousandfivehundredeightyfive -- links -> eightthousandfourhundredeleven;
twentyseventhousandfourhundredfour -- links -> thirtysixthousandeighthundredninetytwo;
twentyseventhousandfourhundredsixtytwo -- links -> twentythreethousandeightyone;
thirtyonethousandnineteen -- links -> twentyninethousandeighthundredtwentyfive;
sixthousandninehundredsixtyseven -- links -> fortythousandonehundredseventyfive;
tenthousandeighthundredthirteen -- links -> threethousandsevenhundredninetyeight;
twentyfourthousandeighthundredthirtynine -- links -> sixteenthousandsixhundredseventysix;
twentyonethousandsixhundredfiftysix -- links -> tenthousandonehundredsixtythree;
fortythreethousandsixhundredfiftythree -- links -> seventeenthousandsixhundredthirtyeight;
thirtyseventhousandfivehundredeightytwo -- links -> twelvethousandtwohundredfiftysix;
twentyninethousandfourhundredfortythree -- links -> thirtyfourthousandninehundredtwentythree;
seventeenthousandthree -- links -> twentythousandthreehundredfifteen;
twentyninethousandsevenhundredthirtyeight -- links -> twentytwothousandsixhundredseventytwo;
sixteenthousandfivehundredtwentysix -- links -> seventhousandfourhundredninetyfour;
thirtyeightthousandtwentyfour -- links -> sixteenthousandsixhundredtwentyone;
thirtytwothousandfourhundredthirtyfour -- links -> twentytwothousandninehundredseventyfour;
eighteenthousandsixhundredeighty -- links -> fourteenthousandsevenhundredfortyfive;
thirtythreethousandsevenhundredthree -- links -> twentythousandsevenhundredseventythree;
eleventhousandfour -- links -> twentyfivethousandonehundredfortysix;
fortyfourthousandfourhundredeightytwo -- links -> twentyfourthousandsevenhundredthirtyseven;
thirtyfourthousandsevenhundredseventysix -- links -> fortysixthousandfourhundredthirtysix;
fortyfivethousandonehundredsixtysix -- links -> twentyeightthousandninehundredtwentysix;
fortytwothousandfivehundredninety -- links -> twentyseventhousandthreehundredsixtythree;
nineteenthousandeighthundredfive -- links -> fivehundredseventyfour;
twelvethousandfourhundredfifty -- links -> fivethousandsevenhundredthirtytwo;
twentyseventhousandsixhundredfortyseven -- links -> sixteenthousandtwohundredfiftyseven;
seventeenthousandfivehundredseventyeight -- links -> thirtysixthousandninehundredseventythree;
twentyeightthousandonehundredseventythree -- links -> thirtyseventhousandtwohundredninetysix;
twentysixthousandfivehundredsixteen -- links -> fortythousandsevenhundredninetyseven;
fivethousandonehundredtwentythree -- links -> fortyonethousandtwohundredthirtyfour;
fourthousandninehundredeighty -- links -> twentythreethousandfourhundredeightysix;
fivethousandthreehundredfiftytwo -- links -> twentytwothousandsevenhundredsix;
thirtyninethousandeighthundredeighty -- links -> thirtythreethousandtwohundredtwentythree;
thirtythousandeighthundredfiftynine -- links -> fortythreethousandtwohundredtwentyfour;
fortyonethousandsevenhundredfiftythree -- links -> twentythousandfivehundredten;
fivethousandfourhundredninetynine -- links -> fortyninethousandfourhundredeleven;
fortytwothousandninehundredtwentyeight -- links -> fortysixthousandonehundredeightyseven;
fortyeightthousandonehundredthirtyone -- links -> fifteenthousandsevenhundredfiftytwo;
eightthousandeighthundredninetynine -- links -> twothousandthreehundredninetyone;
thirtyonethousandonehundredfiftythree -- links -> twentyseventhousandonehundredfiftysix;
twentyfivethousandeighthundredninetynine -- links -> thirtyfivethousandsixhundredeightythree;
thirtysixthousandfourhundredfifty -- links -> thirteenthousandfivehundredninetyseven;
eightthousandonehundredfifteen -- links -> twentyfivethousandfourhundredninetythree;
fortythreethousandsevenhundredeightyseven -- links -> thirtythreethousandsixtythree;
twentyseventhousandthreehundredninetyone -- links -> twentyfourthousandsevenhundredeightytwo;
thirtysixthousandfourhundredtwentytwo -- links -> thirtyfourthousandfourhundrednineteen;
thirtyfivethousandonehundredfiftynine -- links -> thirtytwothousandtwohundredfortyseven;
fortysixthousandtwohundredseventynine -- links -> onethousandtwentysix;
sixthousandeighthundredninetyfour -- links -> twothousandseventythree;
fifteenthousandfivehundredthirty -- links -> thirtyseventhousandthreehundredninetynine;
thirtyonethousandeighthundredeleven -- links -> twelvethousandthreehundredfifteen;
thirtyseventhousandfivehundredsixteen -- links -> twentyonethousandsevenhundredsix;
thirtyfivethousandthreehundredninetyfive -- links -> thirtyeightthousandsevenhundredseventyfour;
fortythousandthreehundredthirtyeight -- links -> twentyonethousandthreehundredsixtyeight;
fortysixthousandtwentyfive -- links -> fourthousandninehundredthirtythree;
threethousandfourhundredsixtyfive -- links -> thirtythreethousandsevenhundredfour;
twelvethousandeighthundredfiftytwo -- links -> fortythreethousandonehundredseventysix;
fortysixthousandfortythree -- links -> thirtyonethousandthreehundredfive;
thirtyeightthousandonehundredsixtythree -- links -> thirtytwothousandfivehundredfiftytwo;
nineteenthousandfourhundredeightythree -- links -> twentyonethousandtwohundredthirtynine;
seventeenthousandfourhundredseventyone -- links -> seventhousandsixhundredeightyfive;
twentyfivethousandfourhundredsixtynine -- links -> thirtyeightthousandfivehundredfiftysix;
thirteenthousandeighthundredsixtyone -- links -> twentythousandtwohundredeightytwo;
fifteenthousandeighthundredsixtyone -- links -> fivethousandonehundredseventyone;
tenthousandfivehundredeleven -- links -> twentyninethousandtwohundredninetyeight;
thirtytwothousandfourhundredfortytwo -- links -> twentysixthousandninehundrednineteen;
fortythousandtwohundredsixtynine -- links -> fortyseventhousandsixhundredsixtyeight;
twelvethousandonehundredthirtyfive -- links -> fourthousandfourhundredfiftyeight;
twentyeightthousandthreehundredseventythree -- links -> thirtyninethousandsixhundredten;
fifteenthousandeighthundredeightysix -- links -> tenthousandtwohundredninety;
seventhousandfivehundredseventythree -- links -> seventeenthousandseventytwo;
thirtyseventhousandonehundredtwentynine -- links -> twentythousandeighthundredfourteen;
eleventhousandfivehundredsixtynine -- links -> threethousandsixhundredseven;
nineteenthousandsixhundredninetyfive -- links -> fortyninethousandonehundredninetyone;
fourthousandsevenhundredone -- links -> fortytwothousandfourhundredseventythree;
twentyonethousandtwohundredthirty -- links -> fortysixthousandone;
fortyeightthousandfivehundredsixtyeight -- links -> fivethousandninehundredninetyone;
thirtyfivethousandtwohundredninetyone -- links -> twentythousandtwohundredseventythree;
twentythousandthreehundredfiftyfive -- links -> thirtyseventhousandonehundredthirtythree;
twentyseventhousandninehundredeightyeight -- links -> twelvethousandninehundredtwenty;
fortysixthousandsixtyone -- links -> thirtyonethousandeighthundredthirtyone;
tenthousandtwohundredseventy -- links -> tenthousandthreehundredninetyseven;
twentysixthousandsevenhundredfortyeight -- links -> threethousandtwohundredsixtytwo;
twentythousandsevenhundredtwenty -- links -> twentyonethousandninehundredfortyfour;
fortyfivethousandfourhundredeighteen -- links -> thirteenthousandninehundredfifteen;
twothousandsixhundredthree -- links -> twentyonethousandfourhundredsixtyseven;
twentyfourthousandeighthundredninety -- links -> twentyseventhousandthirtysix;
thirtyfourthousandfourhundredtwenty -- links -> thirteenthousandsevenhundredtwentythree;
seventeenthousandeighthundredfortyfive -- links -> twentythousandtwohundredtwentyeight;
seventhousandfourhundredeight -- links -> twelvethousandsevenhundredsixtyfour;
thirtyonethousandfourhundredninetyfour -- links -> seventeenthousandeighthundredfiftytwo;
twentytwothousandeighthundredfortythree -- links -> twentyeightthousandfivehundredseventytwo;
fortyseventhousandtwohundredfourteen -- links -> nineteenthousandonehundredtwentyseven;
fortyonethousandtwentyeight -- links -> eighthundredfiftythree;
thirtysixthousandthirtysix -- links -> twentytwothousandeighthundredtwenty;
nineteenthousandeighthundredninetyseven -- links -> thirtyeightthousandonehundredeighteen;
fortyeightthousandsixhundredfive -- links -> sixthousandtwohundredthirtysix;
thirtytwothousandthreehundredfourteen -- links -> twothousandsixhundredfiftyone;
twentythreethousandfourhundredtwentyseven -- links -> twentysixthousandfivehundredfiftyfive;
fortythousandfourhundredninetythree -- links -> thirtyfourthousandfourhundredeight;
twentythousandthreehundredfortytwo -- links -> fortyfourthousandsevenhundredsixtyfour;
twentytwothousandsevenhundredthirtyfour -- links -> fortytwothousandeighthundredthirtyseven;
thirtysixthousandninehundredseventytwo -- links -> fortyseventhousandsevenhundrednine;
fortyseventhousandfivehundredeightyfour -- links -> fortyfivethousandsixhundredeightythree;
thirtyfourthousandfivehundredthirtyfour -- links -> twelvethousandeighthundredsixtysix;
fortyonethousandsevenhundredthirtytwo -- links -> thirtyninethousandonehundredfortynine;
thirtyfourthousandtwohundredeight -- links -> fortythreethousandtwohundredfiftythree;
fortyseventhousandeighthundredtwelve -- links -> fortyonethousandsevenhundredtwentytwo;
seventhousandninehundredfiftysix -- links -> thirtyfivethousandonehundredfortyseven;
fortyfivethousandtwohundredseventyseven -- links -> fortythousandfivehundredninety;
tenthousandsevenhundredeightyone -- links -> fortyonethousandeighthundredseventythree;
twentyseventhousandfivehundredtwentyseven -- links -> seventhousandtwohundredthirtytwo;
seventeenthousandsevenhundredfifteen -- links -> seventhousandthreehundredeightyone;
thirtyfivethousandsixhundredsixtyseven -- links -> eleventhousandeighthundredsixtytwo;
twentytwothousandfourhundredtwentythree -- links -> twentyninethousandseventyfour;
thirtyonethousandtwohundredeighty -- links -> eighthundredfortyfive;
nineteenthousandeighthundredtwenty -- links -> ninethousandtwentyseven;
fortyonethousandonehundredsixtyone -- links -> twentyseventhousandfourhundredthirteen;
sixthousandeighty -- links -> sixteenthousandonehundredfour;
twentyfourthousandonehundredfiftyeight -- links -> twentyfivethousandsevenhundredthirtyseven;
sixteenthousandonehundredsixtysix -- links -> thirtyseventhousandfourhundredfourteen;
twothousandonehundredfiftyeight -- links -> sixteenthousandthreehundredthirtytwo;
fortyfourthousandsevenhundredfiftyfour -- links -> onethousandsixhundredseventythree;
thirtythreethousandsevenhundredninety -- links -> twentysixthousandonehundredfiftynine;
thirtysixthousandeighty -- links -> twelvethousandthreehundredseventythree;
thirtyseventhousandfourhundredsixteen -- links -> thirtyone;
twothousandtwohundredseventythree -- links -> nineteenthousandtwohundredfortytwo;
seventhousandninehundredseventyone -- links -> fortythousandtwohundredeightythree;
ninethousandtwohundredeighteen -- links -> twentythreethousandonehundredtwentysix;
thirteenthousandfourhundredthree -- links -> fortytwothousandfivehundredninetyfive;
fortysixthousandonehundredtwentythree -- links -> seventeenthousandtwentyeight;
fortytwothousandonehundredseventythree -- links -> sixteenthousandtwohundredfour;
twentyonethousandeighthundredseventyfour -- links -> twentytwothousandonehundredninetyfour;
fortyfourthousandeighthundredeightytwo -- links -> sixteenthousandninehundredtwelve;
thirtysixthousandfortyone -- links -> fourthousandninehundredtwentyeight;
twentyonethousandtwohundredfiftythree -- links -> twentytwothousandthirtyfour;
thirtytwothousandtwohundredsixtysix -- links -> twentythousandthreehundredfiftysix;
seventeenthousandninehundredtwentytwo -- links -> fortysixthousandthreehundredsixtyseven;
seventeenthousandfourhundredsixtynine -- links -> fourteenthousandninehundredseven;
fortytwothousandthreehundredfortyeight -- links -> twothousandtwohundredforty;
twentyfivethousandsixhundredfour -- links -> threethousandsixhundredninety;
thirtyfivethousandninehundredfifteen -- links -> fifteenthousandtwohundredtwentyeight;
threethousandthreehundredninetysix -- links -> fortyfivethousandsixhundredeightytwo;
thirtyeightthousandtwohundredfiftyseven -- links -> nineteenthousandonehundredsixtytwo;
thirtyonethousandninehundredfiftytwo -- links -> fortyonethousandfivehundredseventy;
fortyeightthousandonehundredfour -- links -> fortyninethousandtwohundredtwenty;
twothousandfiftyone -- links -> eightthousandsixhundredfortysix;
threethousandfivehundredsixtytwo -- links -> eighteenthousandsixhundred;
thirtytwothousandtwohundredninetyeight -- links -> twentytwothousandeighthundredsixtytwo;
twentyseventhousandthreehundredseven -- links -> thirtyeightthousandsixhundredsixtyfour;
eightthousandninehundredseventytwo -- links -> nineteenthousandeighthundredthirtythree;
fortyfivethousandfortyseven -- links -> fourteenthousandonehundredtwentynine;
fortyfourthousandninehundredfiftyone -- links -> fortytwothousandthreehundredfour;
threethousandeighthundredsixty -- links -> twentyeightthousandonehundredtwenty;
twelvethousandsevenhundredseventyfive -- links -> nineteenthousandfivehundrednineteen;
seventhousandsevenhundredthirtyone -- links -> ninethousandeightyeight;
fourthousandninehundredfortynine -- links -> twentyfivethousandthirtyeight;
twentyfivethousandfivehundredsixtyone -- links -> fourteenthousandthreehundredfortyfive;
twentysixthousandtwohundredfiftyone -- links -> fourhundredthirty;
ninethousandthreehundredthirtytwo -- links -> twentyseventhousandsixhundredeighteen;
fortysixthousandsixtyfour -- links -> fortyninethousandeighthundredfiftyfour;
tenthousandninehundredseventytwo -- links -> fortyninethousandeighthundredseven;
thirtyfourthousandtwohundredtwelve -- links -> seventhousandsixtynine;
fortyonethousandsixhundredforty -- links -> fortytwothousandtwentytwo;
twentythreethousandthreehundredtwentyone -- links -> fortyfourthousandthreehundredfortysix;
twentythousandonehundredseventy -- links -> twentysixthousandfourhundredthirtyfive;
twentytwothousandsevenhundredninetysix -- links -> twentythousandthreehundredninetytwo;
eleventhousandonehundredtwentyeight -- links -> fortythousandsixhundredninetynine;
onethousandfourhundredthirtynine -- links -> twentythousandtwohundredtwentyone;
fourthousandsevenhundredninetytwo -- links -> nineteenthousandfivehundredseventeen;
ninethousandeighthundredfortyfour -- links -> seventhousandsixhundredfiftyeight;
fortysixthousandtwohundredninetyfive -- links -> threethousandfivehundredeight;
thirtyonethousandfourhundred -- links -> tenthousandeighthundredeightyfour;
eleventhousandthreehundredeighteen -- links -> thirtytwothousandeighthundredfiftyeight;
fortythreethousandfourhundredseventeen -- links -> eightthousandsevenhundredsixtyeight;
fortyfourthousandfourhundredninetyseven -- links -> twentysixthousandsevenhundredfortythree;
thirtyonethousandsevenhundredthirtythree -- links -> twentythousandsevenhundredninetyeight;
fortyfourthousandonehundredseventythree -- links -> twentythreethousandonehundredeleven;
fortysixthousandthreehundredeightyfive -- links -> fortythousandsevenhundredsixtyfour;
eleventhousandninehundredfifty -- links -> sixhundredeightyone;
fortytwothousandninehundredfifteen -- links -> fortytwothousandthreehundred;
thirteenthousandninehundredsix -- links -> fortyninethousandonehundredseven;
fourteenthousandfourhundredseventyseven -- links -> twentyeightthousandsixhundredforty;
fortyninethousandtwohundredfortysix -- links -> thirtyeightthousandtwohundredfiftynine;
fortytwothousandsevenhundredfortythree -- links -> threethousandonehundredtwentyone;
fourthousandsevenhundredtwentythree -- links -> fortythousandtwohundredseventytwo;
fourteenthousandninehundredsixtyseven -- links -> onethousandfivehundredeightytwo;
sixthousandeighthundredtwentyeight -- links -> thirtyfivethousandthreehundredsixty;
twentyfourthousandthreehundredthree -- links -> onethousandthreehundredthirty;
sixteenthousandonehundredsixtysix -- links -> threethousandsevenhundredsixtythree;
thirtythreethousandeleven -- links -> twothousandfourhundredfourteen;
fortyninethousandfivehundredsixteen -- links -> twentyonethousandthreehundredeight;
ninethousandfourhundredfortyfive -- links -> eighteenthousandfivehundredeighteen;
twentyfivethousandonehundredeighteen -- links -> sixteenthousandninehundredseventyfive;
nineteenthousandseventyone -- links -> twentysixthousandeighthundredeight;
thirtyninethousandninehundredeightytwo -- links -> fourthousandthreehundredninety;
fourteenthousandfivehundredseventytwo -- links -> twentyfourthousandeighthundredseventy;
ninethousandtwohundredeightyeight -- links -> fourteenthousandtwohundredtwentyone;
threethousandtwohundredthirtysix -- links -> fortysixthousandeighthundredeightyfive;
twentyfivethousandonehundredfifteen -- links -> thirtyseventhousandeighthundredseventy;
fortythreethousandsixhundrednineteen -- links -> twothousandninehundredtwentysix;
twentyninethousandonehundredfiftynine -- links -> eighteenthousandfivehundredeightythree;
seventeenthousandonehundredeightyeight -- links -> fortytwothousandninetyseven;
fortysixthousandninehundredsixtyfive -- links -> eighteenthousandtwohundredsixtythree;
fortytwothousandthreehundredfiftyone -- links -> thirtyfourthousandfourhundredtwentysix;
fortyfivethousandfivehundredsixtyfive -- links -> fortyfivethousandfourhundredthirtytwo;
fifteenthousandfivehundredeighty -- links -> fortyfivethousandsixhundredtwelve;
nineteenthousandeighthundredeighty -- links -> twentyseventhousandthirteen;
thirtythreethousandfivehundredsix -- links -> twentythreethousandsixhundredfortyone;
thirtythousandthreehundredtwentyfour -- links -> twentytwothousandfivehundredfortyone;
fourteenthousandsevenhundredthirtyseven -- links -> thirtysixthousandtwohundredseventysix;
fortyseventhousandonehundredsixtyfive -- links -> twentythreethousandeighthundredtwentyfour;
thirtyeightthousandfivehundredfiftytwo -- links -> twentyfourthousandthreehundredninetyseven;
fortyonethousandonehundredeightytwo -- links -> ninethousandtwohundredfiftyfour;
fifteenthousandsevenhundred -- links -> ninethousandthreehundredseven;
twentyfourthousandeighthundredeightyfour -- links -> onethousandninehundredthree;
twothousandthreehundredfortytwo -- links -> threethousandtwohundredseventythree;
fortythreethousandsixtysix -- links -> fortyseventhousandfourhundredninetythree;
thirtyfivethousandeighthundredfiftysix -- links -> thirtythousandeighthundredtwentythree;
sixteenthousandeighthundredthirtyeight -- links -> ninethousandfourhundredsixtynine;
eighteenthousandsevenhundredeighty -- links -> fortyeightthousandonehundredthirteen;
thirtythousandfourhundredninetysix -- links -> twentyfourthousandfourhundredseventyseven;
twentyseventhousandfourhundredninetysix -- links -> seventeenthousandeighthundredtwenty;
fortyfourthousandtwohundredeighteen -- links -> fortythreethousandninehundredninetyone;
thirtyonethousandfourhundredfiftyeight -- links -> tenthousandtwohundredfour;
sixteenthousandsevenhundredfiftythree -- links -> twentyfivethousandtwohundredsixtyseven;
twentyninethousandfivehundredfortyseven -- links -> fortyseventhousandninehundredeight;
onethousandtwohundredfifteen -- links -> fortyninethousandthreehundredeightyeight;
twothousandsevenhundredseventynine -- links -> thirtysixthousandonehundredseventeen;
thirtythousandsevenhundredtwentynine -- links -> fourthousandtwohundredtwentyfive;
eighteenthousandfourhundredsixtysix -- links -> twelvethousandninehundredfiftyone;
twentyfourthousandeighthundredninetytwo -- links -> fortythousandeighthundredeleven;
twelvethousandsixhundredninetyfour -- links -> threethousandfourhundredseventyseven;
tenthousandonehundredseventyfive -- links -> fifteenthousandeightyfive;
eighteenthousandtwohundredseventy -- links -> seventeenthousandonehundredeightysix;
thirtyseventhousandsixtyone -- links -> twothousandthreehundredfiftynine;
fortyonethousandfivehundredninetyfour -- links -> fortytwothousandninety;
thirtyseventhousandonehundredtwentyone -- links -> seventeenthousandtwohundredsix;
thirtyseventhousandonehundredthirtytwo -- links -> twentythreethousandsevenhundredfortyeight;
threehundredninety -- links -> fourhundredsix;
thirtyninethousandsixhundredeightyseven -- links -> fortyfourthousandthirtyfive;
fortyeightthousandeleven -- links -> twentyfourthousandfivehundredninetynine;
twentyninethousandsixhundredeighteen -- links -> thirtyseventhousandfivehundredthirtytwo;
thirtytwothousandsixhundredseventynine -- links -> fourthousandsixhundredeightyfive;
ninethousandsixhundredseventythree -- links -> fortyninethousandthreehundredfortyfive;
fortyseventhousandseventy -- links -> fortytwothousandfortynine;
twentyseventhousandeighthundredseventythree -- links -> fortysixthousandninehundredseventytwo;
fourthousandninehundredfour -- links -> fortyeightthousandeighthundredeightyfive;
fourteenthousandsixhundredninetyfour -- links -> twentyfourthousandeightyeight;
thirtytwothousandfivehundredtwentytwo -- links -> fourteenthousandfourhundredeightyfive;
eleventhousandninehundredfiftyfive -- links -> fivethousandsixhundredeight;
sixteenthousandsixhundredfortyfour -- links -> twentyfivethousandtwohundredseventythree;
sixthousandonehundredseventytwo -- links -> thirtyonethousandsixtyseven;
onethousandtwohundredfiftyfour -- links -> twentyeightthousandsevenhundredninetyone;
thirteenthousandeighthundredeightythree -- links -> thirtythousandonehundredthree;
fourteenthousandseventynine -- links -> seventeenthousandsevenhundredseventeen;
fortyseventhousandfivehundredten -- links -> fortyseventhousandtwohundredeightytwo;
fortythreethousandsixhundredeightyfour -- links -> fortyfourthousandninehundredeight;
nineteenthousandtwohundredeightynine -- links -> twentytwothousandonehundredtwelve;
fortyfivethousandninehundredseventyeight -- links -> seventeenthousandonehundredtwelve;
thirtyonethousandeighthundredfourteen -- links -> fortysixthousandsixhundredfifteen;
twelvethousandeighthundredninetysix -- links -> thirtyseventhousandthreehundredeightyeight;
fortyseventhousandthreehundredseventeen -- links -> thirtythreethousandninehundredeightytwo;
fortyseventhousandfivehundredseventynine -- links -> thirtysixthousandthreehundredseventy;
seventeenthousandeighthundredone -- links -> sixteenthousandsevenhundredeightyeight;
fourteenthousandeighthundredsixtythree -- links -> tenthousandthreehundredeightyfour;
twentythousandsixhundredseventyfour -- links -> fortyonethousandninehundredninetyseven;
fortyseventhousandfifteen -- links -> thirtyninethousandfourhundredfortysix;
thirteenthousandeighthundredfortyeight -- links -> twentytwothousandfourhundredsix;
eighteenthousandsevenhundredfiftyfour -- links -> eleventhousandtwentyeight;
sixthousandthreehundredthirty -- links -> fortysixthousandninehundredeightysix;
fortytwothousandsevenhundredseventyeight -- links -> twentyeightthousandsevenhundredfortyfive;
fourthousandsevenhundredfiftyfive -- links -> onethousandsevenhundredtwentyfive;
eighteenthousandeighthundredeighteen -- links -> fortyeightthousandsevenhundredtwentysix;
twentyninethousandfourhundredsixtyone -- links -> twentyfourthousandonehundredfortynine;
eleventhousandninetynine -- links -> fortyfourthousand;
thirtyonethousandsixhundredfiftythree -- links -> fortythreethousandfourhundredone;
thirtythreethousandseventyfive -- links -> thirtytwothousandfourhundredtwenty;
thirtyonethousandsevenhundredseventynine -- links -> twentytwothousandfourhundredeightytwo;
fifteenthousandsixtyseven -- links -> thirtyfourthousandthreehundredfortytwo;
fortyseventhousandtwohundredfive -- links -> fourteenthousandeighthundredfourteen;
fortyfivethousandsevenhundredninetyfive -- links -> fortyseventhousandninehundredfiftyfour;
thirtyfourthousandonehundredtwentyseven -- links -> fourthousandeightythree;
thirtyseventhousandeighthundredsixty -- links -> twentyfivethousandninehundredeightyseven;
twentysixthousandfivehundredtwelve -- links -> twentythreethousandfivehundredtwenty;
fortythousandsixhundredone -- links -> fivethousandonehundredfive;
fivethousandninehundredfortyeight -- links -> fortyninethousandfivehundrednineteen;
fourthousandninehundredseventyone -- links -> eighteenthousandthreehundredfortyone;
sixthousandninehundredninetyfour -- links -> thirtyseventhousandfourhundredfifteen;
fortyninethousandthreehundredsixtyeight -- links -> eightthousandfivehundredfiftytwo;
fifteenthousandninehundredtwentynine -- links -> twentytwothousandfourhundredsixtytwo;
thirtytwothousandfourhundredninetyfive -- links -> fivethousandeighthundredeightytwo;
ninethousandonehundredsixteen -- links -> thirtythousandthreehundredninetysix;
thirtyeightthousandonehundredseventyone -- links -> fortythreethousandeighthundredtwentythree;
twentyseventhousandfiftyfive -- links -> thirtyninethousandfourhundredninetyeight;
twentyninethousandonehundredthirty -- links -> eightthousandfivehundredsixteen;
fortyseventhousandonehundredsixtyfour -- links -> twentytwothousandthreehundredfourteen;
nineteenthousandonehundredsixty -- links -> twentyfivethousandeighthundredthirtynine;
eightthousandsixhundredeightyseven -- links -> thirtysixthousandfourhundredeighty;
twentyninethousandfiftythree -- links -> twentythousandsixtyseven;
thirtythreethousandfivehundredfortysix -- links -> eighteenthousandninehundredfortyone;
twentytwothousandfifteen -- links -> thirtyonethousandseventyfour;
twentyonethousandeighthundredfortysix -- links -> thirteenthousandthreehundredeight;
twentythousandtwohundredfortyfive -- links -> sixteenthousandeighthundredsixtytwo;
fivethousandninehundredeleven -- links -> thirtyninethousandninehundredseventythree;
twentyseventhousandsevenhundredeightysix -- links -> fortyseventhousandthreehundredfour;
fourteenthousandtwohundredsixtysix -- links -> twentyfourthousandtwohundredseventytwo;
onethousandfourhundredsixtysix -- links -> fortyonethousandsixhundredfiftyeight;
thirtythreethousandthreehundredseventythree -- links -> fortythousandtwenty;
fifteenthousandfivehundredone -- links -> thirtythreethousandninehundredsixtyeight;
twentythreethousandsixhundredtwentyseven -- links -> twentyseventhousandninehundredsixtyfive;
ninethousandtwohundredtwelve -- links -> fourteenthousandsixtyfour;
eleventhousandtwohundrednineteen -- links -> fifteenthousandtwohundredninetyone;
thirtyseventhousandfivehundredseventytwo -- links -> fourthousandninehundredtwentytwo;
twentythousandeighthundredsixtynine -- links -> twentytwothousandtwohundredseventynine;
twentysixthousandonehundredeightytwo -- links -> thirtysixthousandninehundredeightyseven;
twentyfourthousandsevenhundredseventysix -- links -> twentyeightthousandeightyone;
thirtyonethousandninehundredthirteen -- links -> fourthousandtwohundredtwenty;
fivethousandfivehundredfourteen -- links -> fivethousandfivehundredforty;
twentysixthousandthreehundredsixtyfive -- links -> sixteenthousandtwohundredfortyseven;
twentythousandtwohundredseventyseven -- links -> twentysixthousandeighthundredfiftynine;
seventhousandonehundredsixtyfive -- links -> twentythousandninehundredeightyfive;
sixthousandfivehundredeightysix -- links -> fortythousandthirteen;
thirtyninethousandtwohundredsixtyfour -- links -> thirtyeightthousandonehundredseventynine;
thirtythreethousandthreehundredtwentysix -- links -> fortyseventhousandtwohundredthirtysix;
fivethousandeightythree -- links -> twentyonethousandfourhundredthirtyfive;
fourteenthousandonehundredseventythree -- links -> ninethousandsevenhundredeight;
sixteenthousandeighthundredseventyone -- links -> twelvethousandonehundredninetyone;
fortysixthousandfourhundredninetyfive -- links -> fortyonethousandtwohundredthirtyeight;
fortythousandeighthundredten -- links -> thirtytwothousandonehundredtwentyone;
seventhousandthreehundredeightyone -- links -> threethousandonehundredfortyeight;
fortyseventhousandsevenhundredone -- links -> fortytwothousandsixhundredtwentytwo;
twentyfourthousandeighthundredsixteen -- links -> thirtyfivethousandfivehundredthree;
tenthousandsevenhundredfortyfive -- links -> fortyeightthousandonehundredtwentynine;
twentytwothousandonehundredfortythree -- links -> seventhousandtwohundredtwelve;
twentythreethousandsixhundredtwentythree -- links -> thirtyseventhousandthirteen;
thirtythreethousandsixhundredninetyeight -- links -> eleventhousandfourhundredeightyfive;
fortythreethousandfiftynine -- links -> onethousandsevenhundredfiftynine;
fortythousandonehundredfortyfour -- links -> twentyninethousandfourhundredfiftyone;
fortytwothousandeighthundredsixtyeight -- links -> thirtythousandsevenhundredninetythree;
twentyonethousandthreehundredthirteen -- links -> twentyninethousandtwohundredone;
fortyninethousandfourhundredeightythree -- links -> thirtythreethousandfortythree;
thirtyfivethousandeighthundredthirtythree -- links -> thirtysixthousandthirteen;
seventhousandonehundredninetyseven -- links -> thirtyeightthousandfourhundredfive;
eighteenthousandsixhundredfortytwo -- links -> eighteenthousandsevenhundrednineteen;
eighteenthousandtwohundredtwentytwo -- links -> twentyonethousandninehundredsixtyseven;
twentysixthousandninehundredsixtyfour -- links -> fortyseventhousandsixhundredfour;
fortytwothousandeighthundredtwentyeight -- links -> onethousandtwohundredeightyone;
thirtysixthousandtwohundredsixty -- links -> thirtytwothousandsevenhundred;
fortyonethousandfivehundrednine -- links -> onethousandfourteen;
thirtysixthousandfourhundredsix -- links -> eightthousandtwohundredninetyfive;
fortyseventhousandninetyfour -- links -> thirtyseventhousandninehundredseventynine;
fortyfourthousandeighthundredfortyeight -- links -> eighteenthousandsixtytwo;
thirtythreethousandsixhundredeighteen -- links -> sixthousandseventyeight;
twentyeightthousandeighthundredseventyseven -- links -> fivehundredtwentysix;
twentythousandfivehundredthirtynine -- links -> fortysixthousandfivehundredfortyfive;
twentyeightthousandthreehundredsixtythree -- links -> twentyfivethousandfivehundredsixtyseven;
fortyfourthousandseventynine -- links -> thirtyonethousandsixhundredseventyeight;
fourteenthousandtwohundredtwentysix -- links -> fortyfivethousandfivehundredfiftyfive;
twothousandeighteen -- links -> thirtyeightthousandtwohundredthirteen;
fifteenthousandfourhundredseventythree -- links -> onethousandfifty;
twentyfourthousandninehundredthirtytwo -- links -> twentyninethousandthreehundredtwelve;
fivethousandninehundredseventyfour -- links -> fourthousandtwohundredfiftyeight;
sixthousandsixhundredtwentythree -- links -> onethousandfivehundredninetyone;
seventhousandsevenhundredeightyfive -- links -> fortyseventhousandsevenhundredeightyeight;
thirtysixthousandfourhundredthirtytwo -- links -> onethousandfourhundredthirtynine;
fortysixthousandsevenhundrednine -- links -> fortyeightthousandfourhundredeightynine;
thirtytwothousandfivehundredtwentyseven -- links -> seventhousandsevenhundredtwentysix;
thirtyeightthousandonehundredthirtythree -- links -> sixhundredfortyfour;
twentyfivethousandsixhundredtwentyeight -- links -> fourthousandninehundredseventy;
threethousandninehundredsixty -- links -> thirteenthousandonehundredfortyfour;
eleventhousandeighthundred -- links -> seventeenthousandthreehundredninetyone;
thirtyeightthousandeighty -- links -> eightthousandfivehundredsixtytwo;
fivethousandsixhundredninetythree -- links -> fourteenthousandfivehundredfiftynine;
twentysixthousandeighthundredtwentyeight -- links -> twentyfourthousandthreehundredseventy;
fivethousandsixhundredtwentyseven -- links -> thirtyfourthousandthreehundredeightyseven;
fourthousandsevenhundredfiftyone -- links -> fourthousandthreehundredninetyfive;
thirtyfivethousandeighthundredtwentyfive -- links -> eighthundredninetysix;
fortythreethousandonehundredeightyone -- links -> twentythousandfivehundredthirtyeight;
thirtythreethousandonehundredeight -- links -> thirtyeightthousandsevenhundredtwentyfive;
twelvethousandfiftyone -- links -> sixthousandeighthundredthirtyfive;
onethousandtwohundredninetyfour -- links -> fifteenthousandfourhundrednine;
thirtytwothousandninehundredsixty -- links -> fortyninethousandonehundredfiftyeight;
twentysixthousandfourhundredeightysix -- links -> sixteenthousandeightyone;
fivethousandeighthundredninetyone -- links -> fortysixthousandfivehundredfortyfive;
twentythreethousandfivehundredninetyone -- links -> tenthousandonehundredninetynine;
thirtyonethousandeighthundredninety -- links -> thirtyfivethousandsevenhundredeleven;
thirtytwo -- links -> onethousandfourhundredseventyeight;
fourteenthousandsevenhundredseventytwo -- links -> eighthundredninetyfour;
fortythousandsixhundredninetysix -- links -> thirtyeightthousandtwohundredfifty;
seventeenthousandonehundredfortyeight -- links -> twentyseventhousandninehundredeighteen;
twentythreethousandonehundred -- links -> twelvethousandfivehundredninetysix;
fortyfivethousandtwohundredsixtysix -- links -> twentythousandeightyfive;
onethousandfourhundredfortyseven -- links -> sevenhundredthirtynine;
thirtythousandeighty -- links -> eightthousandninehundredsixty;
fortysixthousandthreehundredsixtyfive -- links -> thirteenthousandninehundredsixtyseven;
sixteenthousandsevenhundredfortytwo -- links -> thirtytwothousandonehundredsixtyfour;
sixteenthousandthreehundredseventyone -- links -> fortyninethousandfourhundredseventy;
thirtyfourthousandfivehundredfiftyfour -- links -> twentyfivethousandfourhundredfortythree;
fortythousandonehundredtwentysix -- links -> fortyseventhousandthreehundredthirtyseven;
tenthousandtwohundredseven -- links -> seventeenthousandsixhundredten;
seventhousandonehundredfiftyeight -- links -> thirtyonethousandeighthundredninetyseven;
fortyeightthousandeighthundredeightyone -- links -> fourthousandsevenhundredten;
twentythreethousandninehundredfiftynine -- links -> ninethousandthirtyfive;
fortysixthousandfivehundredseventyone -- links -> fortythousandeighthundredfiftyfour;
onethousandsixhundredfive -- links -> thirtythreethousandtwohundredninetynine;
tenthousandninehundredsixtyfive -- links -> eighteenthousandsevenhundred;
seventhousandsixhundredtwentyfive -- links -> fortythousandfourhundredninetytwo;
twentysixthousandsixhundredfiftythree -- links -> twentytwothousandonehundredseventyfour;
twentyfivethousandthreehundredforty -- links -> twelvethousandfivehundrednine;
thirteenthousandonehundredfour -- links -> seventeenthousandtwohundredfortyone;
thirtysixthousandninehundredninety -- links -> thirtyseventhousandsevenhundredeightyfour;
fortysixthousandtwohundredtwentynine -- links -> twothousandonehundredsixtyfive;
fortyfivethousandtwelve -- links -> fourteenthousandninehundredtwentyfour;
thirtythousandtwohundredsixtythree -- links -> twentythousandthreehundredseventyone;
thirtytwothousandsevenhundredsixtyfour -- links -> twentysixthousandtwohundredtwo;
twentyfivethousandonehundredninetyeight -- links -> twentyfivethousandeighthundredfiftyeight;
twentythreethousandsixhundredfourteen -- links -> sixthousandfourhundredfour;
twentysixthousandthreehundredtwelve -- links -> twentyfourthousandfourhundredfortynine;
fortyninethousandninehundredeightyfour -- links -> twentythousandninehundredthirteen;
onethousandthirtytwo -- links -> fortyonethousandfourhundredseventytwo;
seventhousandsixhundredtwentytwo -- links -> twentyseventhousandthreehundredseventyfour;
eighteenthousandninehundredseven -- links -> thirtytwothousandthreehundrednineteen;
twentythreethousandninehundredfortyone -- links -> thirtyfivethousandthirtyeight;
fortytwothousandthreehundredseventytwo -- links -> fortyfourthousandsevenhundredfortyfour;
eleventhousandfivehundredtwentythree -- links -> twothousandonehundredninetyfour;
thirtyeightthousandsixhundredfiftynine -- links -> twentysixthousandsevenhundredseventysix;
twentyninethousandthreehundredfiftysix -- links -> fifteenthousandsixhundredfiftytwo;
thirtyeightthousandtwohundredsixtytwo -- links -> thirtyfivethousandfourhundredninetysix;
fortyfourthousandthreehundredseventyone -- links -> fortysixthousandtwohundredeightyfive;
fortytwothousandsixhundredsixtyeight -- links -> thirtysixthousandfourhundredfortytwo;
thirtyfourthousandthreehundredfiftyfive -- links -> twentyseventhousandthreehundredsixtyseven;
thirtyeightthousandeightytwo -- links -> thirteenthousandthreehundredtwentyseven;
fivethousandseventythree -- links -> thirtyonethousandonehundredsixteen;
sixthousandtwohundredfiftytwo -- links -> thirtytwothousandfourhundredthirtyseven;
fortytwothousandfourhundredeightyone -- links -> twentysixthousandtwohundredfive;
twelvethousandeightyone -- links -> fortyeightthousandsevenhundredfifty;
twentythousandninehundredsixtyone -- links -> sixthousandonehundredfortythree;
twentytwothousandeighthundredfiftyone -- links -> tenthousandfortythree;
ninethousandtwentynine -- links -> fifteenthousandonehundredeightythree;
fortysixthousandonehundredfiftyfour -- links -> onethousandsixhundredtwentythree;
fourteenthousandtwohundredtwentyfour -- links -> thirtyeightthousandfivehundredsixtysix;
twentythreethousandsevenhundrednine -- links -> fourthousandseventeen;
sixteenthousandsevenhundredninetyfive -- links -> sixthousandfivehundredsixtyeight;
fortyonethousandtwohundredseventysix -- links -> thirtysixthousandeighthundredtwo;
thirtytwothousandsevenhundredten -- links -> fortyonethousandninehundredtwentyseven;
twelvethousandsevenhundredthirtytwo -- links -> seventhousandfourhundredfiftytwo;
onethousandfivehundredfortyfive -- links -> twentysixthousandeighthundredsixtyeight;
sixteenthousandtwohundredseventytwo -- links -> fifteenthousandthreehundredfortyseven;
fortyonethousandfivehundredfortyone -- links -> twentyonethousandfourhundredtwentynine;
thirtyfourthousandfourhundred -- links -> twentythreethousandonehundredfiftyseven;
twentysixthousandsixhundredeightythree -- links -> thirtyeightthousandfifty;
twelvethousandonehundredthirtyseven -- links -> twentyseventhousandsixhundredfour;
seventeenthousandninehundredtwentyeight -- links -> thirtysixthousandfourhundredtwentysix;
fifteenthousandnine -- links -> fortyfourthousandfourhundredfive;
thirtytwothousandfivehundredfiftyseven -- links -> threethousandsevenhundredfourteen;
twentyonethousandfourhundredseventyseven -- links -> twentyseventhousandsevenhundredfortyfive;
twentyfivethousandsixtythree -- links -> fortyonethousandtwohundredfortyfive;
twentyfourthousandfivehundredseventysix -- links -> fourteenthousandeighthundrednine;
thirtythousandfourhundredthirtyone -- links -> twelvethousandfourhundredtwentyfour;
thirtyeightthousandfourhundredninety -- links -> thirtythousandthreehundredfortytwo;
twentyeightthousandthirtyone -- links -> twothousandthreehundredsixtyfour;
nineteenthousandfiftytwo -- links -> fifteenthousandninehundredtwo;
fortysixthousandtwohundredseventyone -- links -> onethousandfivehundredtwentysix;
fortyfivethousandeighthundrednineteen -- links -> thirtythousandeighthundredfiftyone;
twentyninethousandsixhundredtwentyeight -- links -> threethousandsixhundrednineteen;
fortytwothousandninehundredsixtynine -- links -> fivethousandsevenhundredseventeen;
thirtyseventhousandninehundrednine -- links -> fortyonethousandninetythree;
eleventhousandninehundredthirtynine -- links -> twelvethousandtwohundredninetysix;
thirtysixthousandeighthundredsixtyfive -- links -> fortythousandsixhundredeleven;
twentyonethousandsevenhundredeightythree -- links -> thirtyninethousandfourhundredeight;
twothousandsixhundredeightyeight -- links -> twelvethousandfivehundredseventytwo;
onethousandsevenhundredninetynine -- links -> twelvethousandninehundredfour;
fourteenthousandthreehundredsixtyfour -- links -> thirtysixthousandfivehundredfiftyfive;
fortyeightthousandsixhundredeleven -- links -> twentysixthousandtwohundredeleven;
seventhousandsixhundredninetyone -- links -> fortyonethousandninehundredfiftynine;
fortysixthousandtwohundredseventyeight -- links -> sixthousandseventyfour;
fortyfivethousandonehundredseventytwo -- links -> twentyeightthousandonehundredfortysix;
fortysixthousandonehundredseventyfive -- links -> thirtyfourthousandtwohundredninetyone;
fortyfivethousandonehundredsixteen -- links -> twentythreethousandnine;
twentyonethousandfourhundredseventeen -- links -> twentythreethousandtwohundredeightytwo;
twentyeightthousandseventysix -- links -> seventeenthousandtwohundredfortytwo;
thirtythreethousandeighthundredseventeen -- links -> fortyninethousandsevenhundredseventy;
twentyfourthousandsixtyfive -- links -> thirtyninethousandonehundredfortyfive;
eightthousandtwohundredsixtyone -- links -> twothousandsevenhundredninetysix;
eighteenthousandninehundredfiftynine -- links -> onethousandfivehundredeightytwo;
thirtythousandthreehundredsixteen -- links -> onehundredtwentyeight;
ninethousandseventyfive -- links -> twentyeightthousandtwohundredeightyeight;
twentytwothousandsixtynine -- links -> thirtyninethousandeighthundredseventyfour;
twentyfivethousandthreehundredthirtyone -- links -> twentyfourthousandsixhundredtwentynine;
thirtythreethousandtwohundredthirtynine -- links -> thirtyfivethousandsevenhundredfortyseven;
twentyninethousandsixty -- links -> nineteenthousandninetyseven;
eightthousandfourhundredninetyeight -- links -> seventhousandfourhundredtwentyfour;
ninethousandfivehundredthirteen -- links -> thirtytwothousandsixhundredeightythree;
fourteenthousandeighthundredeightynine -- links -> fortyseventhousandfivehundredthirtysix;
sixthousandsevenhundredthirtyeight -- links -> thirtythreethousandsixhundredtwentyfour;
fortythousandfourhundredsixtyone -- links -> fortyfivethousandeighthundredthirty;
fivethousandtwohundredeightyeight -- links -> thirtyfivethousandtwohundredthirtyone;
fortyfivethousandonehundredseventyfive -- links -> eighthundredthirtyeight;
thirtyeightthousandtwohundredfiftynine -- links -> fourteenthousandthreehundredseventyone;
fortythreethousandeightynine -- links -> twentytwothousandeighthundredtwentyone;
thirtyninethousandfourhundredthirtyone -- links -> thirtyfivethousandtwohundredsixtythree;
sixteenthousandonehundredfortyfive -- links -> thirtyeightthousandeighthundredten;
twentytwothousandeighthundredfortyone -- links -> fortyeightthousandonehundredseventynine;
eighteenthousandonehundredsixtythree -- links -> thirtytwothousandtwohundredeight;
threethousandonehundredsixtynine -- links -> twentyonethousandfivehundredninetyseven;
fortyfivethousandeighthundredseventyfour -- links -> twentyonethousandsevenhundredeightynine;
thirtyeightthousandonehundredfiftyeight -- links -> nineteenthousandsixhundredthirtyfive;
fortyfivethousandninehundredtwentythree -- links -> twentyfivethousandeighthundredfiftythree;
thirtythreethousandeighthundredfiftysix -- links -> fortyfourthousandfivehundredfiftyseven;
fifteenthousandthreehundredfiftynine -- links -> twelvethousandsevenhundredninetyone;
onethousandeighthundredfourteen -- links -> thirteenthousandninehundredfour;
thirtytwothousandthreehundredfifteen -- links -> thirtyonethousandeighthundredfiftyseven;
fortythreethousandsixhundredsixtyeight -- links -> fortytwothousandfivehundredsixtyfour;
sixteenthousandsevenhundredtwentyfive -- links -> nineteenthousandfourhundredfiftysix;
onethousandfiftyseven -- links -> thirtyseventhousandsixhundredtwentytwo;
threethousandtwohundredseventysix -- links -> eleventhousandtwohundredtwentythree;
thirtyseventhousandtwohundredfiftynine -- links -> fortythreethousandsixhundredseventyfour;
thirtyeightthousandninehundredseventytwo -- links -> fortythreethousandfiftysix;
onethousandninehundredninetyone -- links -> thirtyonethousandonehundredtwentynine;
tenthousandfourhundredtwentyone -- links -> fivethousandfourhundredsixtyfive;
thirtytwothousandsevenhundredtwentynine -- links -> eleventhousandonehundredfortyfour;
fivethousandninehundredtwentyeight -- links -> fivethousandninehundredfiftyeight;
fortytwothousandsixhundredthirtysix -- links -> fourhundredtwentyfive;
sixhundredeightyfive -- links -> fortythousandeighthundredeightyfive;
ninethousandonehundredtwo -- links -> twentyseventhousandfivehundredninetyfour;
thirtyonethousandonehundredfiftysix -- links -> onethousandthreehundredfortytwo;
twentythousandtwohundredfiftyone -- links -> seventeenthousandfourhundredfiftytwo;